nu                  	ny                  
onfangt             	OnfANt              
wat                 	wAt                 
aal                 	a:l                 
aan                 	a:n                 
aandacht            	a:ndAxt             
aandachtig          	a:ndAxtIg           
aandoen             	a:ndun              
aanhooren           	a:nho:r@n           
aanmaatige          	a:nma:tIg@          
aanneemen           	a:n@m@n             
aanschouwen         	a:nsxAuw@n          
aanschouwers        	a:nsxAuw@rs         
aansien             	a:nsin              
aanstonds           	a:nstOnds           
aanstootelyks       	a:nsto:t@lIks       
aar                 	a:r                 
aardig              	a:rdIg              
aars                	a:rs                
aart                	a:rt                
aasem               	a:s@m               
accedemy            	Ak@d@mi             
accoord             	Ako:rt              
ach                 	Ax                  
acht                	Axt                 
achten              	Axt@n               
achter              	Axt@                
achtste             	Axtst@              
ad                  	At                  
adstrucsy           	AdstrYksi           
advers              	Adv@s               
aen                 	a:n                 
aenzien             	a:nzin              
aer                 	a:r                 
aerdig              	a:rdIg              
aert                	a:rt                
aertje              	a:rtj@              
aêl                	a:l                 
aêr                	a:r                 
aêrs               	a:rs                
af                  	Af                  
afbyten             	Afbit@n             
afgedaan            	Afx@da:n            
afgeschroffeld      	Afx@sxrOf@lt        
afgesteeken         	Afx@st@k@n          
afkaatsen           	Afka:ts@n           
aftemeeten          	Aft@m@t@n           
aftestryken         	Aft@strik@n         
ageeren             	Ax@r@n              
al                  	Al                  
aldaar              	Alda:r              
aldien              	Aldin               
aldus               	AldYs               
alewijn             	Al@win              
alewyn              	Al@win              
algemeen            	Alx@m@n             
all                 	Al                  
alle                	Al@                 
alleen              	Al@n                
alleman             	Al@mAn              
allen               	Al@n                
alles               	Al@s                
allien              	Alin                
alls                	Als                 
alrieds             	Alrids              
als                 	Als                 
alsoo               	Also:               
altegaer            	Alt@xa:r            
althans             	AltAns              
altoos              	Alto:s              
altyd               	Altit               
alwaar              	Alwa:r              
amsteldam           	Amst@ldAm           
angst               	ANst                
anne                	An@                 
antwoord            	Antwo:rt            
april               	AprIl               
as                  	As                  
asia                	Asia:               
attesteeren         	At@st@r@n           
aut                 	Aut                 
avond               	AvOnt               
baalde              	ba:ld@              
baaren              	ba:r@n              
baeren              	ba:r@n              
bagatellen          	bAxAt@l@n           
bak                 	bAk                 
bakkes              	bAkk@s              
baldus              	bAldYs              
balken              	bAlk@n              
ballen              	bAl@n               
balsem              	bAls@m              
bassen              	bAs@n               
bastonneeren        	bAstOn@r@n          
bed                 	b@t                 
bedaar              	b@da:r              
bedaard             	b@da:rt             
bede                	b@d@                
bedenken            	b@d@nk@n            
bedieden            	b@did@n             
bedot               	b@dOt               
bedotten            	b@dOt@n             
bedrooge            	b@dro:x@            
bedroogen           	b@dro:x@n           
bedryf              	b@drif              
bedryten            	b@drit@n            
bedryven            	b@driv@n            
beduit              	b@d9yt              
beelt               	b@lt                
been                	b@n                 
beest               	b@st                
bef                 	b@f                 
begaan              	b@xa:n              
begeerende          	b@x@r@nd@           
begin               	b@xIn               
beginnen            	b@xIn@n             
begint              	b@xInt              
begraaven           	b@xra:v@n           
begrypen            	b@xrip@n            
behalven            	b@hAlv@n            
behandeld           	b@hAnd@lt           
behoesten           	b@hust@n            
behoord             	b@ho:rt             
behooren            	b@ho:r@n            
behoorlyk           	b@ho:rlIk           
behoort             	b@ho:rt             
bek                 	b@k                 
bekeeven            	b@k@v@n             
beken               	b@k@n               
bekend              	b@k@nt              
bekenden            	b@k@nd@n            
bekennen            	b@k@n@n             
bekent              	b@k@nt              
beklaaglyke         	b@kla:xlIk@         
beklat              	b@klAt              
beknopt             	b@knOpt             
bekyken             	b@kik@n             
belaaden            	b@la:d@n            
belaagen            	b@la:x@n            
belaên             	b@la:n              
beleedigen          	b@l@dIx@n           
beleezen            	b@l@z@n             
belet               	b@l@t               
beletten            	b@l@t@n             
bellen              	b@l@n               
beloft              	b@lOft              
beloof              	b@lo:f              
beloofd             	b@lo:ft             
beloofje            	b@lo:fj@            
belooft             	b@lo:ft             
belooven            	b@lo:v@n            
bemind              	b@mInt              
ben                 	b@n                 
benevens            	b@n@v@ns            
benje               	b@nj@               
bennen              	b@n@n               
benoemt             	b@numt              
benouwen            	b@nAuw@n            
bent                	b@nt                
beplyten            	b@plit@n            
bepraeten           	b@pra:t@n           
beschermheeren      	b@sx@rmh@r@n        
bescherminge        	b@sx@rmIN@          
beschryven          	b@sxriv@n           
beslaagen           	b@sla:x@n           
beslabben           	b@slAb@n            
beslikte            	b@slIkt@            
beslissen           	b@slIs@n            
besluit             	b@sl9yt             
besse               	b@s@                
best                	b@st                
bestaen             	b@sta:n             
beste               	b@st@               
besteeden           	b@st@d@n            
bestevaar           	b@st@va:r           
besukte             	b@sYkt@             
betaalen            	b@ta:l@n            
betaaling           	b@ta:lIN            
betaelen            	b@ta:l@n            
beticht             	b@tIxt              
betiên             	b@tin               
bevat               	b@vAt               
beveelje            	b@v@lj@             
bevonden            	b@vOnd@n            
bevoorens           	b@vo:r@ns           
bevrijen            	b@vri@n             
bewaart             	b@wa:rt             
bewoogen            	b@wo:x@n            
bewys               	b@wis               
bewysen             	b@wis@n             
bewyzen             	b@wiz@n             
bezaadigd           	b@za:dIxt           
bezint              	b@zInt              
bezoeken            	b@zuk@n             
bezwaard            	b@zwa:rt            
bezwaeren           	b@zwa:r@n           
bichten             	bIxt@n              
bid                 	bIt                 
bidje               	bIdj@               
bier                	bir                 
billen              	bIl@n               
billyk              	bIlik               
binje               	bInj@               
binnen              	bIn@n               
bits                	bIts                
blaân              	bla:n               
blad                	blAt                
blauwe              	blAuw@              
bleef               	bl@f                
bleek               	bl@k                
blind               	blInt               
blinden             	blInd@n             
bloed               	blut                
bloeijen            	blui@n              
bloemen             	blum@n              
bloemfestoen        	blumf@stun          
bloempje            	blumpj@             
bloempjes           	blumpj@s            
bloesem             	blus@m              
blom                	blOm                
bloosje             	blo:sj@             
bly                 	bli                 
blyf                	blif                
blyven              	bliv@n              
blyvende            	bliv@nd@            
boek                	buk                 
boekje              	bukj@               
boel                	bul                 
boenen              	bun@n               
boer                	bur                 
boere               	bur@                
boeren              	bur@n               
boerin              	burIn               
boertjes            	burtj@s             
boete               	but@                
boeten              	but@n               
boevenstukken       	buv@nstYkk@n        
boksen              	bOks@n              
bolle               	bOl@                
bondel              	bOnd@l              
bondig              	bOndIg              
bondige             	bOndIg@             
bonk                	bOnk                
boode               	bo:d@               
boomen              	bo:m@n              
booter              	bo:t@               
bouwen              	bAuw@n              
braaf               	bra:f               
braajen             	bra:i@n             
braef               	bra:f               
brande              	brAnd@              
breed               	br@t                
breede              	br@d@               
breek               	br@k                
breeken             	br@k@n              
breekspul           	br@kspYl            
breekt              	br@kt               
brengt              	br@t                
breuk               	br@k                
briefjes            	brifj@s             
brieven             	briv@n              
brocht              	brOxt               
broek               	bruk                
brokken             	brOkk@n             
brood               	bro:t               
brugman             	brYxmAn             
bruid               	br9yt               
bruigom             	br9yxOm             
bruiloft            	br9ylOft            
bruiloften          	br9ylOft@n          
bruiloftsfeest      	br9ylOftsf@st       
buigen              	b9yx@n              
buiksloot           	b9ykslo:t           
buiten              	b9yt@n              
bukken              	bYkk@n              
bullepees           	bYl@p@s             
bundel              	bYnd@l              
bunschoten          	bYnsxOt@n           
by                  	bi                  
byget               	bix@t               
byten               	bit@n               
byzyn               	bizin               
cees                	k@s                 
centrom             	k@ntrOm             
claar               	kla:r               
claartje            	kla:rtj@            
coert               	kurt                
collationeeren      	kOlAtio:n@r@n       
compleet            	kOmpl@t             
condemneeren        	kOnd@mn@r@n         
consente            	kOns@nt@            
continuatie         	kOntInya:ti         
contra              	kOntra:             
cootjes             	ko:tj@s             
credit              	kr@dIt              
crelis              	kr@lIs              
daad                	da:t                
daag                	da:x                
daanschouwers       	da:nsxAuw@rs        
daar                	da:r                
daarom              	da:rOm              
daer                	da:r                
daerde              	da:rd@              
daerom              	da:rOm              
daet                	da:t                
dag                 	dAx                 
dak                 	dAk                 
dan                 	dAn                 
dank                	dAnk                
dankje              	dAnkj@              
das                 	dAs                 
dat                 	dAt                 
datj                	dAtj                
datje               	dAtj@               
datmen              	dAtm@n              
dats                	dAts                
dattestanten        	dAt@stAnt@n         
datze               	dAtz@               
dauws               	dAuws               
davocaaten          	dAvOkAt@n           
de                  	d@                  
dee                 	d@                  
deed                	d@t                 
deeden              	d@d@n               
deel                	d@l                 
deele               	d@l@                
deen                	d@n                 
deene               	d@n@                
deer                	d@r                 
deerste             	d@rst@              
dees                	d@s                 
deeze               	d@z@                
deezen              	d@z@n               
deezer              	d@z@                
deezes              	d@z@s               
demonstreeren       	d@mOnstr@r@n        
den                 	d@n                 
dende               	d@nd@               
denk                	d@nk                
denken              	d@nk@n              
denkt               	d@nkt               
des                 	d@s                 
dese                	d@s@                
deselve             	d@s@lv@             
desen               	d@s@n               
dewyl               	d@wil               
deze                	d@z@                
dezelve             	d@z@lv@             
dezen               	d@z@n               
dezes               	d@z@s               
dicht               	dIxt                
dichte              	dIxt@               
dicteeren           	dIkt@r@n            
die                 	di                  
diefje              	difj@               
diek                	dik                 
dien                	din                 
dienaar             	dina:r              
dienen              	din@n               
dienst              	dinst               
dienste             	dinst@              
dient               	dint                
diepe               	dip@                
diergelyk           	dirx@lIk            
dies                	dis                 
dik                 	dIk                 
dikketons           	dIkk@tOns           
dikmaals            	dIkma:ls            
dilay               	dIlAi               
ding                	dIN                 
dingen              	dIN@n               
discoerzen          	dIskurz@n           
distinctelyk        	dIstInkt@lIk        
itto                	Ito:                
doch                	dOx                 
docht               	dOxt                
doctoor             	dOkto:r             
doe                 	du                  
doeje               	duj@                
doek                	duk                 
doeken              	duk@n               
doelen              	dul@n               
doen                	dun                 
doende              	dund@               
doenmaals           	dunma:ls            
doet                	dut                 
dog                 	dOx                 
dol                 	dOl                 
dood                	do:t                
doodelyk            	do:d@lIk            
doof                	do:f                
doogen              	do:x@n              
doolen              	do:l@n              
doop                	do:p                
door                	do:r                
dooren              	do:r@n              
doorgronden         	do:rxrOnd@n         
doorleezen          	do:rl@z@n           
dooven              	do:v@n              
douwe               	dAuw@               
douwen              	dAuw@n              
draad               	dra:t               
draag               	dra:x               
draajen             	dra:i@n             
draaven             	dra:v@n             
draed               	dra:t               
draegen             	dra:x@n             
draelen             	dra:l@n             
drasbroek           	drAsbruk            
drek                	dr@k                
drie                	dri                 
drift               	drIft               
driften             	drIft@n             
drilhuis            	drIlh9ys            
drillen             	drIl@n              
dringende           	drIN@nd@            
drink               	drInk               
drinken             	drInk@n             
droes               	drus                
droeve              	druv@               
drogen              	drOx@n              
drok                	drOk                
drommel             	drOm@l              
droog               	dro:x               
drooge              	dro:x@              
droogen             	dro:x@n             
droomde             	dro:md@             
droomen             	dro:m@n             
dropje              	drOpj@              
drucken             	drYk@n              
druilen             	dr9yl@n             
druipen             	dr9yp@n             
drukken             	drYkk@n             
dubbeld             	dYb@lt              
duigen              	d9yx@n              
duim                	d9ym                
duitspraak          	d9ytspra:k          
dun                 	dYn                 
dunkt               	dYnkt               
dus                 	dYs                 
dwang               	dwAN                
dwingen             	dwIN@n              
dwong               	dwON                
dyk                 	dik                 
eclipseert          	@klIps@rt           
edelman             	@d@lmAn             
ee                  	@                   
eed                 	@t                  
een                 	@n                  
eenen               	@n@n                
eenig               	@nIg                
eenige              	@nIg@               
eenigste            	@nIxst@             
eenlyk              	@nlIk               
eenmaal             	@nma:l              
eenmael             	@nma:l              
eenpaarig           	@npa:rIg            
eens                	@ns                 
eensdeels           	@nsd@ls             
eer                 	@r                  
eerbied             	@rbit               
eeren               	@r@n                
eerlyk              	@rlIk               
eerst               	@rst                
eerste              	@rst@               
eersten             	@rst@n              
eertj               	@rtj                
eertje              	@rtj@               
eerws               	@rws                
eeten               	@t@n                
eeven               	@v@n                
effect              	@f@kt               
ehad                	@hAt                
ekreegen            	@kr@x@n             
el                  	@l                  
eleegen             	@l@x@n              
elk                 	@lk                 
elkaer              	@lka:r              
eloogen             	@lo:x@n             
elselaantje         	@ls@la:ntj@         
elsje               	@lsj@               
em                  	@m                  
emalt               	@mAlt               
en                  	@n                  
end                 	@nt                 
ende                	@nd@                
enfo                	@nfo:               
enkele              	@nk@l@              
entwintig           	@ntwIntIg           
etsi                	@tsi                
even                	@v@n                
eveneens            	@v@n@ns             
ewent               	@w@nt               
ezeid               	@z@t                
faam                	fa:m                
fatsoen             	fAtsun              
february            	f@brya:ri           
feeks               	f@ks                
feilen              	f@l@n               
feit                	f@t                 
felten              	f@lt@n              
figmenten           	fIxm@nt@n           
flap                	flAp                
fleemend            	fl@m@nt             
fleemende           	fl@m@nd@            
flippus             	flIppYs             
floor               	flo:r               
floortjen           	flo:rtj@n           
fluks               	flYks               
foei                	fui                 
foob                	fo:p                
fout                	fAut                
fraay               	fra:i               
freek               	fr@k                
fulpe               	fYlp@               
fymelaar            	fim@la:r            
fymelaêr           	fim@la:r            
ga                  	xa:                 
gaa                 	xa:                 
gaan                	xa:n                
gaande              	xa:nd@              
gaat                	xa:t                
gae                 	xa:                 
gaen                	xa:n                
gaer                	xa:r                
gaet                	xa:t                
gaf                 	xAf                 
gal                 	xAl                 
gang                	xAN                 
gans                	xAns                
gantsch             	xAnts               
gast                	xAst                
gat                 	xAt                 
gatje               	xAtj@               
gauw                	xAuw                
gebaarden           	x@ba:rd@n           
gebeden             	x@b@d@n             
gebeên             	x@b@n               
gebleeken           	x@bl@k@n            
gebleeven           	x@bl@v@n            
gebonden            	x@bOnd@n            
geboomte            	x@bo:mt@            
geboortestad        	x@bo:rt@stAt        
gebraaden           	x@bra:d@n           
gebracht            	x@brAxt             
gebrek              	x@br@k              
gebril              	x@brIl              
gebroed             	x@brut              
geconsenteert       	x@kOns@nt@rt        
gedaagde            	x@da:xd@            
gedaagden           	x@da:xd@n           
gedaagdes           	x@da:xd@s           
gedaan              	x@da:n              
gedacht             	x@dAxt              
gedachten           	x@dAxt@n            
gedaen              	x@da:n              
gedeelte            	x@d@lt@             
gedogen             	x@dOx@n             
gedooken            	x@do:k@n            
gedreeven           	x@dr@v@n            
gedroopen           	x@dro:p@n           
gedruckt            	x@drYkt             
gedruilt            	x@dr9ylt            
gedrukt             	x@drYkt             
geduld              	x@dYlt              
geduldig            	x@dYldIg            
gedulds             	x@dYlds             
geef                	x@f                 
geeft               	x@ft                
geen                	x@n                 
geerne              	x@rn@               
geest               	x@st                
geestig             	x@stIg              
geeven              	x@v@n               
gegaan              	x@xa:n              
gegeeven            	x@x@v@n             
gehad               	x@hAt               
geheel              	x@h@l               
geheelt             	x@h@lt              
geheeten            	x@h@t@n             
gehouden            	x@hAud@n            
gehouwen            	x@hAuw@n            
gek                 	x@k                 
gekeelt             	x@k@lt              
gekleed             	x@kl@t              
gekoomen            	x@ko:m@n            
gelaat              	x@la:t              
gelag               	x@lAx               
geld                	x@lt                
geleden             	x@l@d@n             
geleeden            	x@l@d@n             
geleerd             	x@l@rt              
geleezen            	x@l@z@n             
geleên             	x@l@n               
gelegt              	x@l@xt              
gelen               	x@l@n               
gelet               	x@l@t               
geliefden           	x@lifd@n            
gelieven            	x@liv@n             
geloofbaare         	x@lo:fba:r@         
geloogen            	x@lo:x@n            
geloopen            	x@lo:p@n            
gelooven            	x@lo:v@n            
gelubde             	x@lYbd@             
gemaakt             	x@ma:kt             
gemaklyk            	x@mAklIk            
gemeen              	x@m@n               
gemoed              	x@mut               
gemoet              	x@mut               
genaamd             	x@na:mt             
genaamt             	x@na:mt             
genegen             	x@n@x@n             
genieten            	x@nit@n             
genigen             	x@nIx@n             
genoeg              	x@nux               
genood              	x@no:t              
genoomen            	x@no:m@n            
genootsaakt         	x@no:tsa:kt         
gepaerd             	x@pa:rt             
geplaatst           	x@pla:tst           
gepleeten           	x@pl@t@n            
gepruilt            	x@pr9ylt            
geschieden          	x@sxid@n            
geschiet            	x@sxit              
geschiên           	x@sxin              
geschut             	x@sxYt              
geselschap          	x@s@lsxAp           
geslacht            	x@slAxt             
geslagt             	x@slAxt             
gesloopen           	x@slo:p@n           
gesnap              	x@snAp              
gesoen              	x@sun               
gesol               	x@sOl               
gespannen           	x@spAn@n            
gesprek             	x@spr@k             
gesprooten          	x@spro:t@n          
gestaan             	x@sta:n             
gesteld             	x@st@lt             
gestoffeert         	x@stOf@rt           
gestommel           	x@stOm@l            
gestooken           	x@sto:k@n           
gestoolen           	x@sto:l@n           
gestooven           	x@sto:v@n           
gestreeken          	x@str@k@n           
get                 	x@t                 
getalm              	x@tAlm              
getreeden           	x@tr@d@n            
getrouwd            	x@trAuwt            
getuigen            	x@t9yx@n            
getuignis           	x@t9yxnIs           
geval               	x@vAl               
geven               	x@v@n               
gevoerd             	x@vurt              
gevoert             	x@vurt              
gevolg              	x@vOlx              
gevolgt             	x@vOlxt             
gevonden            	x@vOnd@n            
geween              	x@w@n               
geweest             	x@w@st              
geweeten            	x@w@t@n             
geweld              	x@w@lt              
gewis               	x@wIs               
gewonnen            	x@wOn@n             
gezegt              	x@z@xt              
gezelschap          	x@z@lsxAp           
gezet               	x@z@t               
gezicht             	x@zIxt              
gezien              	x@zin               
gien                	xin                 
ging                	xIN                 
gissen              	xIs@n               
gistren             	xIstr@n             
glas                	xlAs                
goe                 	xu                  
goed                	xut                 
goede               	xud@                
goeje               	xuj@                
gong                	xON                 
gooit               	xo:it               
goosens             	xo:s@ns             
graag               	xra:x               
gracy               	xrAs                
graeg               	xra:x               
grauwt              	xrAuwt              
greep               	xr@p                
grillen             	xrIl@n              
grimlacht           	xrImlAxt            
grimmeld            	xrIm@lt             
groen               	xrun                
grof                	xrOf                
grond               	xrOnt               
gronden             	xrOnd@n             
grondig             	xrOndIg             
groot               	xro:t               
groote              	xro:t@              
grootjes            	xro:tj@s            
grootte             	xro:t@              
grote               	xrOt@               
grouwen             	xrAuw@n             
grypen              	xrip@n              
guil                	x9yl                
guilen              	x9yl@n              
guldens             	xYld@ns             
gun                 	xYn                 
gunst               	xYnst               
gy                  	xi                  
haalt               	ha:lt               
haamlebout          	ha:ml@bAut          
haan                	ha:n                
haantje             	ha:ntj@             
haar                	ha:r                
haard               	ha:rt               
haare               	ha:r@               
haarig              	ha:rIg              
haast               	ha:st               
haazepad            	ha:z@pAt            
had                 	hAt                 
hadden              	hAd@n               
haelen              	ha:l@n              
haer                	ha:r                
haeren              	ha:r@n              
haest               	ha:st               
haestig             	ha:stIg             
half                	hAlf                
hallef              	hAl@f               
hals                	hAls                
hand                	hAnt                
handen              	hAnd@n              
hangen              	hAN@n               
hanggat             	hANxAt              
hangoor             	hANo:r              
hans                	hAns                
hapt                	hApt                
he                  	h@                  
heb                 	h@p                 
hebbe               	h@b@                
hebben              	h@b@n               
hebbende            	h@b@nd@             
hebj                	h@bj                
hebje               	h@bj@               
hebt                	h@pt                
hebze               	h@bz@               
heeft               	h@ft                
heel                	h@l                 
heele               	h@l@                
heelen              	h@l@n               
heemel              	h@m@l               
heen                	h@n                 
heenen              	h@n@n               
heer                	h@r                 
heeren              	h@r@n               
heerschip           	h@rsxIp             
heggen              	h@x@n               
hek                 	h@k                 
helaas              	h@la:s              
help                	h@lp                
helpen              	h@lp@n              
helpje              	h@lpj@              
helpt               	h@lpt               
hem                 	h@m                 
hen                 	h@n                 
hendrik             	h@ndrIk             
het                 	h@t                 
hiel                	hil                 
hiele               	hil@                
hier                	hir                 
hikkende            	hIkk@nd@            
ho                  	ho:                 
hoe                 	hu                  
hoed                	hut                 
hoedraakt           	hudra:kt            
hoeft               	huft                
hoer                	hur                 
hoertje             	hurtj@              
hoesen              	hus@n               
hoewel              	huw@l               
hof                 	hOf                 
holland             	hOlAnt              
hond                	hOnt                
hoofd               	ho:ft               
hooft               	ho:ft               
hoog                	ho:x                
hoogen              	ho:x@n              
hoogsten            	ho:xst@n            
hoopen              	ho:p@n              
hoor                	ho:r                
hooren              	ho:r@n              
hoort               	ho:rt               
hooy                	ho:i                
hop                 	hOp                 
hou                 	hAu                 
houd                	hAut                
houden              	hAud@n              
houdende            	hAud@nd@            
houtskool           	hAutsko:l           
houwen              	hAuw@n              
huer                	hyr                 
huilebalk           	h9yl@bAlk           
huilen              	h9yl@n              
huilende            	h9yl@nd@            
huilt               	h9ylt               
huis                	h9ys                
huizen              	h9yz@n              
hulp                	hYlp                
hun                 	hYn                 
hunne               	hYn@                
hy                  	hi                  
hyze                	hiz@                
ibi                 	Ibi                 
iemand              	imAnt               
ien                 	in                  
iens                	ins                 
iets                	its                 
ik                  	Ik                  
immensis            	Im@nsIs             
impregnavit         	Impr@xnAvIt         
in                  	In                  
inbeelden           	Inb@ld@n            
influeren           	Inflyr@n            
inhoude             	InhAud@             
inne                	In@                 
insonderheid        	InsOnd@h@t          
interpoosen         	Int@po:s@n          
intreên            	Intr@n              
inwendige           	Inw@ndIg@           
is                  	Is                  
ja                  	ja:                 
jaagen              	ja:x@n              
jaap                	ja:p                
jaapje              	ja:pj@              
jaar                	ja:r                
jaaren              	ja:r@n              
jaars               	ja:rs               
jacht               	jAxt                
jachtig             	jAxtIg              
jaegt               	ja:xt               
jaep                	ja:p                
jaer                	ja:r                
jaeren              	ja:r@n              
jan                 	jAn                 
janken              	jAnk@n              
janne               	jAn@                
jannetje            	jAn@tj@             
je                  	j@                  
jegens              	j@x@ns              
jem                 	j@m                 
jemy                	j@mi                
jesse               	j@s@                
jet                 	j@t                 
jochem              	jOx@m               
jongen              	jON@n               
jongmans            	jONmAns             
jongspel            	jONsp@l             
jongspul            	jONspYl             
jons                	jOns                
joppen              	jOpp@n              
jou                 	jAu                 
joului              	jAul9y              
jouwen              	jAuw@n              
jouwent             	jAuw@nt             
juffrouw            	jYfrAuw             
juist               	j9yst               
jy                  	ji                  
kaarsen             	ka:rs@n             
kaart               	ka:rt               
kaele               	ka:l@               
kal                 	kAl                 
kalf                	kAlf                
kan                 	kAn                 
kans                	kAns                
kansje              	kAnsj@              
kant                	kAnt                
kap                 	kAp                 
keel                	k@l                 
keeren              	k@r@n               
keert               	k@rt                
kees                	k@s                 
ken                 	k@n                 
kenje               	k@nj@               
kennis              	k@nIs               
kent                	k@nt                
kies                	kis                 
kind                	kInt                
kindsgebeenten      	kIndsx@b@nt@n       
kinkel              	kInk@l              
kinkels             	kInk@ls             
klaar               	kla:r               
klaare              	kla:r@              
klaartje            	kla:rtj@            
klacht              	klAxt               
klachten            	klAxt@n             
klad                	klAt                
kladde              	klAd@               
klaer               	kla:r               
klaeren             	kla:r@n             
klappen             	klApp@n             
kleeren             	kl@r@n              
kleêren            	kl@r@n              
klerk               	kl@k                
klompen             	klOmp@n             
klop                	klOp                
kloppen             	klOpp@n             
kloppende           	klOpp@nd@           
klopt               	klOpt               
klouwen             	klAuw@n             
kluiten             	kl9yt@n             
knaphandig          	knAphAndIg          
kneep               	kn@p                
kneepen             	kn@p@n              
kneppels            	kn@pp@ls            
knie                	kni                 
knier               	knir                
kniertje            	knirtj@             
knikkebeen          	knIkk@b@n           
knikkende           	knIkk@nd@           
knikt               	knIkt               
knoesten            	knust@n             
knol                	knOl                
knollen             	knOl@n              
knolles             	knOl@s              
knoppen             	knOpp@n             
koek                	kuk                 
koeken              	kuk@n               
kom                 	kOm                 
kommer              	kOm@                
komt                	kOmt                
kon                 	kOn                 
koningen            	kOnIN@n             
kool                	ko:l                
koomen              	ko:m@n              
koop                	ko:p                
koos                	ko:s                
koot                	ko:t                
kop                 	kOp                 
koppelaar           	kOpp@la:r           
kosten              	kOst@n              
koud                	kAut                
kraag               	kra:x               
kraajen             	kra:i@n             
kraam               	kra:m               
kraamtyd            	kra:mtit            
krabben             	krAb@n              
kracht              	krAxt               
krachten            	krAxt@n             
kraeken             	kra:k@n             
kreeg               	kr@x                
kreek               	kr@k                
krenken             	kr@nk@n             
krenten             	kr@nt@n             
krieken             	krik@n              
krielen             	kril@n              
kruipen             	kr9yp@n             
kruis               	kr9ys               
krukken             	krYkk@n             
krygen              	krix@n              
krygende            	krix@nd@            
kryn                	krin                
krynen              	krin@n              
kunnen              	kYn@n               
kunst               	kYnst               
kunt                	kYnt                
kusje               	kYsj@               
kusjes              	kYsj@s              
kwaad               	kwa:t               
kwae                	kwa:                
kwam                	kwAm                
kwast               	kwAst               
kwellen             	kw@l@n              
kwyl                	kwil                
kwyt                	kwit                
kyk                 	kik                 
kyken               	kik@n               
kykuit              	kik9yt              
kynd                	kInt                
kyven               	kiv@n               
laan                	la:n                
laat                	la:t                
laaten              	la:t@n              
laater              	la:t@               
laatste             	la:tst@             
laazen              	la:z@n              
lachen              	lAx@n               
laelyk              	la:lIk              
laen                	la:n                
laet                	la:t                
laeten              	la:t@n              
lag                 	lAx                 
lam                 	lAm                 
land                	lAnt                
lande               	lAnd@               
landen              	lAnd@n              
lang                	lAN                 
lange               	lAN@                
langs               	lANs                
langzaam            	lANza:m             
lap                 	lAp                 
lapje               	lApj@               
las                 	lAs                 
laste               	lAst@               
lasten              	lAst@n              
ledig               	l@dIg               
leed                	l@t                 
leek                	l@k                 
leelyk              	l@lIk               
leen                	l@n                 
leeren              	l@r@n               
leert               	l@rt                
leest               	l@st                
leeven              	l@v@n               
leevens             	l@v@ns              
leezen              	l@z@n               
leg                 	l@x                 
leggen              	l@x@n               
legt                	l@xt                
lenden              	l@nd@n              
lest                	l@st                
letten              	l@t@n               
licht               	lIxt                
lichte              	lIxt@               
lichten             	lIxt@n              
lichtlyk            	lIxtlIk             
lieden              	lid@n               
liedje              	lidj@               
lief                	lif                 
liefd               	lift                
liefde              	lifd@               
liefdens            	lifd@ns             
lieffelyke          	lif@lIk@            
liefkoost           	lifko:st            
liefst              	lifst               
liep                	lip                 
liet                	lit                 
lieve               	liv@                
liên               	lin                 
ligt                	lIxt                
lijen               	li@n                
likken              	lIkk@n              
linden              	lInd@n              
lippen              	lIpp@n              
loeren              	lur@n               
loerend             	lur@nt              
lompe               	lOmp@               
lompen              	lOmp@n              
loof                	lo:f                
loogen              	lo:x@n              
loopen              	lo:p@n              
los                 	lOs                 
lossen              	lOs@n               
louwtjens           	lAuwtj@ns           
lubben              	lYb@n               
luidkeels           	l9ydk@ls            
luimen              	l9ym@n              
luisenek            	l9ys@n@k            
luistren            	l9ystr@n            
luitjes             	l9ytj@s             
lukken              	lYkk@n              
lust                	lYst                
lustig              	lYstIg              
luy                 	lYi                 
luyster             	lYIst@              
ly                  	li                  
lyd                 	lit                 
lydde               	lId@                
lyden               	lid@n               
lyf                 	lif                 
lyjen               	lij@n               
lywaat              	liwa:t              
maag                	ma:x                
maak                	ma:k                
maaken              	ma:k@n              
maakende            	ma:k@nd@            
maakje              	ma:kj@              
maakt               	ma:kt               
maal                	ma:l                
maand               	ma:nt               
maanden             	ma:nd@n             
maanlicht           	ma:nlIxt            
maar                	ma:r                
macht               	mAxt                
maek                	ma:k                
maeken              	ma:k@n              
maekt               	ma:kt               
maenen              	ma:n@n              
maer                	ma:r                
maet                	ma:t                
mag                 	mAx                 
magt                	mAxt                
mai                 	mAi                 
mal                 	mAl                 
malkaar             	mAlka:r             
malle               	mAl@                
mallen              	mAl@n               
man                 	mAn                 
mand                	mAnt                
manden              	mAnd@n              
mannen              	mAn@n               
mannenbroek         	mAn@nbruk           
mannenhuis          	mAn@nh9ys           
mans                	mAns                
manu                	mAny                
maski               	mAski               
mat                 	mAt                 
me                  	m@                  
mede                	m@d@                
medely              	m@d@li              
mee                 	m@                  
meed                	m@t                 
meede               	m@d@                
meedoogend          	m@do:x@nt           
meen                	m@n                 
meenen              	m@n@n               
meening             	m@nIN               
meenj               	m@nj                
meent               	m@nt                
meer                	m@r                 
meest               	m@st                
meeste              	m@st@               
meesten             	m@st@n              
meezen              	m@z@n               
meê                	m@                  
meêr               	m@r                 
mekaer              	m@ka:r              
melis               	m@lIs               
men                 	m@n                 
menig               	m@nIg               
menigmaalen         	m@nIxma:l@n         
mensk               	m@nsk               
mentie              	m@nti               
mer                 	m@                  
met                 	m@t                 
middels             	mId@ls              
midden              	mId@n               
middlen             	mIdl@n              
mien                	min                 
mies                	mis                 
min                 	mIn                 
minnelusjes         	mIn@lYsj@s          
minneviertje        	mIn@virtj@          
minst               	mInst               
minste              	mInst@              
minsten             	mInst@n             
mis                 	mIs                 
misdaan             	mIsda:n             
misdryven           	mIsdriv@n           
misduiden           	mIsd9yd@n           
misschien           	mIsxin              
missen              	mIs@n               
mits                	mIts                
mocht               	mOxt                
moe                 	mu                  
moed                	mut                 
moeilyk             	muilIk              
moeiten             	muit@n              
moer                	mur                 
moertje             	murtj@              
moest               	must                
moesten             	must@n              
moet                	mut                 
moeten              	mut@n               
moezen              	muz@n               
moêr               	mur                 
mompelende          	mOmp@l@nd@          
mompelt             	mOmp@lt             
momus               	mOmYs               
mond                	mOnt                
monde               	mOnd@               
moogelyk            	mo:x@lIk            
moogen              	mo:x@n              
moogje              	mo:xj@              
mooglyk             	mo:xlIk             
mooi                	mo:i                
mooije              	mo:i@               
mooy                	mo:i                
mouw                	mAuw                
muffen              	mYf@n               
munt                	mYnt                
my                  	mi                  
myn                 	min                 
myne                	min@                
na                  	na:                 
naaden              	na:d@n              
naakt               	na:kt               
naakte              	na:kt@              
naam                	na:m                
naar                	na:r                
naargedruckt        	na:rx@drYkt         
naargedruckte       	na:rx@drYkt@        
naast               	na:st               
nacht               	nAxt                
nadeel              	nAd@l               
nader               	nAd@                
nadrukken           	nAdrYkk@n           
nae                 	na:                 
naer                	na:r                
naêr               	na:r                
nauw                	nAuw                
neel                	n@l                 
neeltje             	n@ltj@              
neemen              	n@m@n               
neemje              	n@mj@               
neemt               	n@mt                
neen                	n@n                 
neer                	n@r                 
neerduitsch         	n@rd9yts            
neet                	n@t                 
neêrgeset          	n@rx@s@t            
nemaar              	n@ma:r              
nemen               	n@m@n               
net                 	n@t                 
netjes              	n@tj@s              
nevens              	n@v@ns              
niemand             	nimAnt              
niet                	nit                 
niets               	nits                
nieuwe              	niyu@               
noch                	nOx                 
noem                	num                 
noemen              	num@n               
noemt               	numt                
nog                 	nOx                 
nood                	no:t                
noodig              	no:dIg              
noodje              	no:dj@              
nooit               	no:it               
nou                 	nAu                 
nu                  	ny                  
nut                 	nYt                 
nygende             	nix@nd@             
och                 	Ox                  
octroy              	OktrOi              
octroye             	Oktro:i@            
octroyeren          	Oktro:i@r@n         
of                  	Of                  
ofte                	Oft@                
olyk                	OlIk                
om                  	Om                  
omissie             	OmIsi               
omkeeren            	Omk@r@n             
omme                	Om@                 
omni                	Omni                
omtrent             	Omtr@nt             
onbehoorlyks        	Onb@ho:rlIks        
onbekrompen         	Onb@krOmp@n         
onbewust            	Onb@wYst            
onderwyl            	Ond@wil             
ongzent             	ONz@nt              
onheblyks           	Onh@blIks           
onlangs             	OnlANs              
onmoogelyk          	Onmo:x@lIk          
onmooglyk           	Onmo:xlIk           
onnoodig            	Ono:dIg             
onnoosle            	Ono:sl@             
onnopsle            	OnOpsl@             
onnut               	OnYt                
ons                 	Ons                 
onse                	Ons@                
onsen               	Ons@n               
onses               	Ons@s               
onsmaaklyk          	Onsma:klIk          
ontbreeken          	Ontbr@k@n           
ontdekken           	Ontd@kk@n           
onteeren            	Ont@r@n             
ontkennen           	Ontk@n@n            
ontlooken           	Ontlo:k@n           
ontloopen           	Ontlo:p@n           
ontmoet             	Ontmut              
ontmoetende         	Ontmut@nd@          
ontroofd            	Ontro:ft            
ontrooven           	Ontro:v@n           
ontvrachten         	OntvrAxt@n          
onty                	Onti                
ontydig             	OntidIg             
ontzeggen           	Ontz@x@n            
ontzegging          	Ontz@xIN            
ontzegt             	Ontz@xt             
onwilligheid        	OnwIlIg@t           
onze                	Onz@                
onzen               	Onz@n               
oog                 	o:x                 
oogen               	o:x@n               
oogwit              	o:xwIt              
ooit                	o:it                
ook                 	o:k                 
oordeelt            	o:rd@lt             
ooren               	o:r@n               
oorsprong           	o:rsprON            
oorzaak             	o:rza:k             
oost                	o:st                
op                  	Op                  
opdragt             	OpdrAxt             
open                	Op@n                
openbaeren          	Op@nba:r@n          
opende              	Op@nd@              
opgaan              	Opxa:n              
opgepast            	Opx@pAst            
opgepropt           	Opx@prOpt           
opgetoogen          	Opx@to:x@n          
opgetooid           	Opx@to:it           
opschrift           	OpsxrIft            
opslaan             	Opsla:n             
opstaande           	Opsta:nd@           
opstond             	OpstOnt             
opstonds            	OpstOnds            
otten               	Ot@n                
oude                	Aud@                
ouden               	Aud@n               
ouwe                	Auw@                
ouwerwetse          	Auw@rw@ts@          
ô                  	o:                  
paait               	pa:it               
paal                	pa:l                
paar                	pa:r                
paardje             	pa:rdj@             
paars               	pa:rs               
pad                 	pAt                 
paer                	pa:r                
paeren              	pa:r@n              
pak                 	pAk                 
pakje               	pAkj@               
pampieren           	pAmpir@n            
pan                 	pAn                 
papier              	pApir               
papieren            	pApir@n             
papiertjes          	pApirtj@s           
pas                 	pAs                 
passe               	pAs@                
passeeren           	pAs@r@n             
penen               	p@n@n               
pennen              	p@n@n               
penning             	p@nIN               
piek                	pik                 
pier                	pir                 
piet                	pit                 
pik                 	pIk                 
pikken              	pIkk@n              
pislap              	pIslAp              
plaagen             	pla:x@n             
plaas               	pla:s               
plaats              	pla:ts              
plaatsen            	pla:ts@n            
plaets              	pla:ts              
plag                	plAx                
plaisier            	plAisir             
plakt               	plAkt               
plat                	plAt                
platte              	plAt@               
pleeg               	pl@x                
pluist              	pl9yst              
plukken             	plYkk@n             
pluwier             	plyuir              
plyt                	plit                
plyten              	plit@n              
poelsnip            	pulsnIp             
poen                	pun                 
poene               	pun@                
pollen              	pOl@n               
ponzekoek           	pOnz@kuk            
poogt               	po:xt               
pooijen             	po:i@n              
poosen              	po:s@n              
poot                	po:t                
pooten              	po:t@n              
post                	pOst                
pot                 	pOt                 
praat               	pra:t               
praaten             	pra:t@n             
praatende           	pra:t@nd@           
prachen             	prAx@n              
praesertim          	pra:s@tIm           
praet               	pra:t               
praeten             	pra:t@n             
praetjes            	pra:tj@s            
prinsedent          	prIns@d@nt          
proppen             	prOpp@n             
prossedeeren        	prOs@d@r@n          
pruimen             	pr9ym@n             
prulle              	prYl@               
prullen             	prYl@n              
pry                 	pri                 
prys                	pris                
pryzen              	priz@n              
puit                	p9yt                
punt                	pYnt                
qua                 	kwa:                
quid                	kwIt                
raad                	ra:t                
raaken              	ra:k@n              
raakend             	ra:k@nt             
raakt               	ra:kt               
raakte              	ra:kt@              
raar                	ra:r                
rabbelende          	rAb@l@nd@           
raed                	ra:t                
raeken              	ra:k@n              
raekje              	ra:kj@              
raekt               	ra:kt               
raet                	ra:t                
raên               	ra:n                
randen              	rAnd@n              
rang                	rAN                 
rank                	rAnk                
ranken              	rAnk@n              
rebel               	r@b@l               
ree                 	r@                  
reede               	r@d@                
reeden              	r@d@n               
reedenen            	r@d@n@n             
reeds               	r@ds                
reets               	r@ts                
reên               	r@n                 
regenten            	r@x@nt@n            
repje               	r@pj@               
repliek             	r@plik              
reproche            	r@prOx@             
rest                	r@st                
resumptie           	r@sYmpti            
ribben              	rIb@n               
rinkelrooijen       	rInk@lro:i@n        
rispeteeren         	rIsp@t@r@n          
roeijen             	rui@n               
roep                	rup                 
roept               	rupt                
roeren              	rur@n               
rogge               	rOx@                
rok                 	rOk                 
rolle               	rOl@                
rond                	rOnt                
ronde               	rOnd@               
rondom              	rOndOm              
rooseknopje         	ro:s@knOpj@         
roosen              	ro:s@n              
roosje              	ro:sj@              
rooven              	ro:v@n              
rouwen              	rAuw@n              
rubben              	rYb@n               
ruikt               	r9ykt               
ruim                	r9ym                
rust                	rYst                
rustelyk            	rYst@lIk            
ryke                	rik@                
rylt                	rIlt                
rype                	rip@                
ryzen               	riz@n               
saacke              	sa:k@               
saam                	sa:m                
sabben              	sAb@n               
saemen              	sa:m@n              
saggelaer           	sAx@la:r            
sakje               	sAkj@               
sal                 	sAl                 
saysoen             	sAisun              
schaaden            	sxa:d@n             
schaamt             	sxa:mt              
schaatsen           	sxa:ts@n            
schaf               	sxAf                
schand              	sxAnt               
schat               	sxAt                
schenken            	sx@nk@n             
schennis            	sx@nIs              
schepen             	sx@p@n              
schepenen           	sx@p@n@n            
schermen            	sx@rm@n             
schiefhals          	sxifhAls            
schik               	sxIk                
schol               	sxOl                
schoon              	sxo:n               
schouder            	sxAud@              
schout              	sxAut               
schoutbelt          	sxAutb@lt           
schouts             	sxAuts              
schouwen            	sxAuw@n             
schraale            	sxra:l@             
schrift             	sxrIft              
schriften           	sxrIft@n            
schrifts            	sxrIfts             
schryvende          	sxriv@nd@           
schudden            	sxYd@n              
schuifjes           	sx9yfj@s            
schuil              	sx9yl               
schuilt             	sx9ylt              
schuit              	sx9yt               
schuld              	sxYlt               
schuldig            	sxYldIg             
schut               	sxYt                
schyn               	sxin                
schynschoon         	sxInsxo:n           
schynt              	sxInt               
schyven             	sxiv@n              
se                  	s@                  
secreeten           	s@kr@t@n            
sed                 	s@t                 
sellementen         	s@l@m@nt@n          
selleweeken         	s@l@w@k@n           
selve               	s@lv@               
selven              	s@lv@n              
seneca              	s@n@k               
sesde               	s@sd@               
setten              	s@t@n               
sevende             	s@v@nd@             
seventien           	s@v@ntin            
sic                 	sIk                 
sig                 	sIg                 
sikken              	sIkk@n              
sileen              	sIl@n               
silency             	sIl@ns              
simon               	sImOn               
sint                	sInt                
sla                 	sla:                
slaan               	sla:n               
slaande             	sla:nd@             
slaap               	sla:p               
slaapeloose         	sla:p@lo:s@         
slaapende           	sla:p@nd@           
slaat               	sla:t               
slaen               	sla:n               
slaepen             	sla:p@n             
sleepen             	sl@p@n              
slegts              	sl@xts              
slendrum            	sl@ndrYm            
slet                	sl@t                
slieren             	slir@n              
sloeg               	slux                
sloof               	slo:f               
slooten             	slo:t@n             
slopje              	slOpj@              
sluit               	sl9yt               
sluiten             	sl9yt@n             
sluitende           	sl9yt@nd@           
slypen              	slip@n              
smakje              	smAkj@              
smeekt              	sm@kt               
smeeren             	sm@r@n              
smooren             	smo:r@n             
smout               	smAut               
smyten              	smit@n              
snaak               	sna:k               
snap                	snAp                
snapt               	snApt               
snavel              	snAv@l              
snede               	sn@d@               
snee                	sn@                 
snel                	sn@l                
snikkende           	snIkk@nd@           
snol                	snOl                
snollen             	snOl@n              
snot                	snOt                
so                  	so:                 
socraat             	sOkra:t             
soenen              	sun@n               
soentje             	suntj@              
soerzen             	surz@n              
soet                	sut                 
sollen              	sOl@n               
soo                 	so:                 
sot                 	sOt                 
soude               	sAud@               
souden              	sAud@n              
spaak               	spa:k               
spaar               	spa:r               
spaart              	spa:rt              
specteert           	sp@kt@rt            
speelen             	sp@l@n              
speelt              	sp@lt               
spel                	sp@l                
spelkonst           	sp@lkOnst           
spelletje           	sp@l@tj@            
spillen             	spIl@n              
spit                	spIt                
splyt               	split               
splyten             	split@n             
spoeijen            	spui@n              
spoelen             	spul@n              
spoor               	spo:r               
spotten             	spOt@n              
spouwen             	spAuw@n             
sprak               	sprAk               
spreek              	spr@k               
spreeken            	spr@k@n             
spreekt             	spr@kt              
springen            	sprIN@n             
springt             	sprINt              
sprinkt             	sprInkt             
spul                	spYl                
spyt                	spit                
spyten              	spit@n              
sta                 	sta:                
staaltjes           	sta:ltj@s           
staan               	sta:n               
staat               	sta:t               
stad                	stAt                
stae                	sta:                
staeje              	sta:j@              
stael               	sta:l               
staen               	sta:n               
staet               	sta:t               
staje               	stAj@               
stand               	stAnt               
stapmen             	stApm@n             
stappen             	stApp@n             
stee                	st@                 
steeds              	st@ds               
steek               	st@k                
steeken             	st@k@n              
steelen             	st@l@n              
steelt              	st@lt               
steê               	st@                 
steên              	st@n                
stel                	st@l                
stellen             	st@l@n              
stelpen             	st@lp@n             
sterren             	st@r@n              
stée               	st@                 
stil                	stIl                
stille              	stIl@               
stillen             	stIl@n              
stilletjes          	stIl@tj@s           
stinken             	stInk@n             
stip                	stIp                
stoel               	stul                
stoelen             	stul@n              
stof                	stOf                
stoffe              	stOf@               
stok                	stOk                
stokslagen          	stOkslAx@n          
stokvis             	stOkvIs             
stom                	stOm                
stond               	stOnt               
stoot               	sto:t               
stoppen             	stOpp@n             
stoute              	stAut@              
straat              	stra:t              
straet              	stra:t              
straks              	strAks              
streelen            	str@l@n             
streelt             	str@lt              
strekken            	str@kk@n            
stronk              	strOnk              
stroo               	stro:               
stroop              	stro:p              
stryd               	strit               
stryken             	strik@n             
stuk                	stYk                
stukken             	stYkk@n             
stulp               	stYlp               
styf                	stif                
styn                	stin                
styven              	stiv@n              
subject             	sYbj@kt             
sul                 	sYl                 
sulks               	sYlks               
sullen              	sYl@n               
sult                	sYlt                
swaan               	swa:n               
swaantje            	swa:ntj@            
swaantjes           	swa:ntj@s           
swaen               	swa:n               
swaentje            	swa:ntj@            
swaentjes           	swa:ntj@s           
swak                	swAk                
sweer               	sw@r                
sweeren             	sw@r@n              
sweerje             	sw@rj@              
swiet               	swit                
sy                  	si                  
syn                 	sin                 
taafél             	ta:f@l              
taal                	ta:l                
tael                	ta:l                
tafel               	tAf@l               
tafelbel            	tAf@lb@l            
taffronteeren       	tAfrOnt@r@n         
tanden              	tAnd@n              
tang                	tAN                 
tas                 	tAs                 
te                  	t@                  
teegen              	t@x@n               
teegens             	t@x@ns              
teegenspreeken      	t@x@nspr@k@n        
teemen              	t@m@n               
teer                	t@r                 
tegen               	t@x@n               
tegens              	t@x@ns              
ten                 	t@n                 
theses              	t@s@s               
thuis               	t9ys                
tmynent             	tmin@nt             
to                  	to:                 
toch                	tOx                 
toe                 	tu                  
toechaalt           	tuxa:lt             
toegemeeten         	tux@m@t@n           
toegesonden         	tux@sOnd@n          
toegestaan          	tux@sta:n           
toekomende          	tukOm@nd@           
toen                	tun                 
toeslaande          	tusla:nd@           
toesond             	tusOnt              
toffel              	tOf@l               
toneele             	tOn@l@              
tong                	tON                 
tontloopen          	tOntlo:p@n          
tonzent             	tOnz@nt             
toon                	to:n                
tooneel             	to:n@l              
tooneele            	to:n@l@             
tooneels            	to:n@ls             
toonel              	to:n@l              
toonen              	to:n@n              
toornig             	to:rnIg             
tot                 	tOt                 
traan               	tra:n               
traanen             	tra:n@n             
trad                	trAt                
traenen             	tra:n@n             
trant               	trAnt               
trappen             	trApp@n             
trapt               	trApt               
treed               	tr@t                
treeden             	tr@d@n              
treedende           	tr@d@nd@            
treên              	tr@n                
trek                	tr@k                
trekt               	tr@kt               
treves              	tr@v@s              
triomfeeren         	trio:mf@r@n         
troost              	tro:st              
trouw               	trAuw               
trouwbeloft         	trAuwb@lOft         
trouwen             	trAuw@n             
tryn                	trin                
twede               	tw@d@               
twee                	tw@                 
tweede              	tw@d@               
twie                	twi                 
twien               	twin                
twintigsten         	twIntIxst@n         
twyfflen            	twIfl@n             
tyd                 	tit                 
tydig               	tidIg               
tys                 	tis                 
tzaam               	tza:m               
uil                 	9yl                 
uit                 	9yt                 
uiten               	9yt@n               
uitgemalt           	9ytx@mAlt           
uitgespeelt         	9ytx@sp@lt          
uitgezongen         	9ytx@zON@n          
uitkomst            	9ytkOmst            
uitstellen          	9ytst@l@n           
uw                  	yu                  
uwent               	yu@nt               
vaar                	va:r                
vaart               	va:rt               
vaer                	va:r                
vaerdig             	va:rdIg             
vaeren              	va:r@n              
vaertj              	va:rtj              
vaertje             	va:rtj@             
vaêr               	va:r                
vaêren             	va:r@n              
vaêrtje            	va:rtj@             
vallen              	vAl@n               
vals                	vAls                
valsch              	vAls                
valt                	vAlt                
van                 	vAn                 
vangen              	vAN@n               
vast                	vAst                
vaste               	vAst@               
vat                 	vAt                 
veeg                	v@x                 
veel                	v@l                 
veelen              	v@l@n               
veen                	v@n                 
veenboer            	v@nbur              
veer                	v@r                 
veeren              	v@r@n               
veertien            	v@rtin              
veldlied            	v@ldlit             
vellen              	v@l@n               
vent                	v@nt                
venten              	v@nt@n              
ventje              	v@ntj@              
verdriet            	v@drit              
verrast             	v@rAst              
verre               	v@r@                
vette               	v@t@                
veul                	v@l                 
vier                	vir                 
vierde              	vird@               
vierschaar          	virsxa:r            
villen              	vIl@n               
vind                	vInt                
vinden              	vInd@n              
violenta            	vio:l@nta:          
vissen              	vIs@n               
vliegen             	vlix@n              
vliegend            	vlix@nt             
vliegt              	vlixt               
vloer               	vlur                
vloo                	vlo:                
vloog               	vlo:x               
vlugge              	vlYx@               
voddemoêr          	vOd@mur             
voegt               	vuxt                
voel                	vul                 
voelende            	vul@nd@             
voelt               	vult                
voeren              	vur@n               
voet                	vut                 
voeten              	vut@n               
voetjes             	vutj@s              
voetteeren          	vut@r@n             
voên               	vun                 
vol                 	vOl                 
voldongen           	vOldON@n            
volg                	vOlx                
volgen              	vOlx@n              
volgende            	vOlx@nd@            
volgt               	vOlxt               
volk                	vOlk                
volkje              	vOlkj@              
voltrekken          	vOltr@kk@n          
voltrokken          	vOltrOkk@n          
vond                	vOnt                
vonden              	vOnd@n              
vonnis              	vOnIs               
voogd               	vo:xt               
voor                	vo:r                
voorbaet            	vo:rba:t            
voordeel            	vo:rd@l             
vooren              	vo:r@n              
voorgemelde         	vo:rx@m@ld@         
voorheen            	vo:rh@n             
voorheenen          	vo:rh@n@n           
voorige             	vo:rIg@             
voorkoomen          	vo:rko:m@n          
voornaamentlyk      	vo:rna:m@ntlIk      
voornaamst          	vo:rna:mst          
voort               	vo:rt               
voortgaan           	vo:rtxa:n           
voortgebracht       	vo:rtx@brAxt        
voorts              	vo:rts              
voorvallen          	vo:rvAl@n           
voorwaar            	vo:rwa:r            
vóor               	vo:r                
vraagen             	vra:x@n             
vrachtman           	vrAxtmAn            
vraegen             	vra:x@n             
vredelyk            	vr@d@lIk            
vreden              	vr@d@n              
vreeden             	vr@d@n              
vreemde             	vr@md@              
vrees               	vr@s                
vreezen             	vr@z@n              
vriend              	vrint               
vrienden            	vrind@n             
vriendschap         	vrindsxAp           
vrijelyk            	vri@lIk             
vrijen              	vri@n               
vrind               	vrInt               
vrinden             	vrInd@n             
vrindschap          	vrIndsxAp           
vroedwyf            	vrudwif             
vroeg               	vrux                
vroegjes            	vruxj@s             
vroeten             	vrut@n              
vroom               	vro:m               
vroome              	vro:m@              
vry                 	vri                 
vryft               	vrIft               
vryven              	vriv@n              
vuil                	v9yl                
vuilbaard           	v9ylba:rt           
vuile               	v9yl@               
vuist               	v9yst               
vyf                 	vif                 
vygen               	vix@n               
vyven               	viv@n               
waafels             	wa:f@ls             
waagen              	wa:x@n              
waar                	wa:r                
waard               	wa:rt               
waardig             	wa:rdIg             
waaren              	wa:r@n              
waarheid            	wa:rh@t             
waarlyke            	wa:rlIk@            
waarom              	wa:rOm              
waasem              	wa:s@m              
wacht               	wAxt                
wachten             	wAxt@n              
wachtje             	wAxtj@              
waer                	wa:r                
waerdig             	wa:rdIg             
waereld             	wa:r@lt             
waerom              	wa:rOm              
waerschouw          	wa:rsxAuw           
waert               	wa:rt               
waeyen              	wa:i@n              
wal                 	wAl                 
wambus              	wAmbYs              
wandeling           	wAnd@lIN            
wangen              	wAN@n               
wanneer             	wAn@r               
want                	wAnt                
was                 	wAs                 
wassenaar           	wAs@na:r            
wat                 	wAt                 
watte               	wAt@                
weeken              	w@k@n               
weer                	w@r                 
weerom              	w@rOm               
wees                	w@s                 
weesen              	w@s@n               
weesende            	w@s@nd@             
weet                	w@t                 
weeten              	w@t@n               
weetens             	w@t@ns              
weetenschap         	w@t@nsxAp           
weezen              	w@z@n               
weêr               	w@r                 
weêrom             	w@rOm               
weêrzyds           	w@rzIds             
weg                 	w@x                 
wel                 	w@l                 
weleboore           	w@l@bo:r@           
welk                	w@lk                
welke               	w@lk@               
welriekende         	w@lrik@nd@          
wesen               	w@s@n               
westvriesland       	w@stvrislAnt        
wet                 	w@t                 
weten               	w@t@n               
wetenschap          	w@t@nsxAp           
wetten              	w@t@n               
wickevoort          	wIk@vo:rt           
wie                 	wi                  
wieg                	wix                 
wiel                	wil                 
wiens               	wins                
wier                	wir                 
wierd               	wirt                
wil                 	wIl                 
wilje               	wIlj@               
willen              	wIl@n               
willende            	wIl@nd@             
wilspeelen          	wIlsp@l@n           
wilt                	wIlt                
winnen              	wIn@n               
wint                	wInt                
wis                 	wIs                 
wollenaajen         	wOl@na:i@n          
wond                	wOnt                
woonen              	wo:n@n              
woord               	wo:rt               
woorden             	wo:rd@n             
wou                 	wAu                 
wreed               	wr@t                
wroedwyf            	wrudwif             
wrong               	wrON                
wy                  	wi                  
wyd                 	wit                 
wyf                 	wif                 
wyl                 	wil                 
wylje               	wIlj@               
wyn                 	win                 
wys                 	wis                 
wyse                	wis@                
wyst                	wIst                
wyvenrok            	wiv@nrOk            
wyze                	wiz@                
wyzen               	wiz@n               
ygelyk              	ix@lIk              
ymand               	imAnt               
ymands              	imAnds              
ypecryt             	ip@krit             
ys                  	is                  
zaak                	za:k                
zaaken              	za:k@n              
zaakje              	za:kj@              
zaam                	za:m                
zaamen              	za:m@n              
zaamenspraaken      	za:m@nspra:k@n      
zachjes             	zAxj@s              
zacht               	zAxt                
zachtzinnig         	zAxtzInIg           
zaek                	za:k                
zaekje              	za:kj@              
zaem                	za:m                
zaemen              	za:m@n              
zagje               	zAxj@               
zak                 	zAk                 
zakken              	zAkk@n              
zakpyp              	zAkpip              
zal                 	zAl                 
zalje               	zAlj@               
zalmen              	zAlm@n              
zalze               	zAlz@               
zand                	zAnt                
zat                 	zAt                 
ze                  	z@                  
zee                 	z@                  
zeg                 	z@x                 
zegele              	z@x@l@              
zeggen              	z@x@n               
zeggens             	z@x@ns              
zegje               	z@xj@               
zegt                	z@xt                
zel                 	z@l                 
zelf                	z@lf                
zelfs               	z@lfs               
zelje               	z@lj@               
zelve               	z@lv@               
zelven              	z@lv@n              
zend                	z@nt                
zes                 	z@s                 
zet                 	z@t                 
zetten              	z@t@n               
zettende            	z@t@nd@             
zeven               	z@v@n               
zevende             	z@v@nd@             
zich                	zIx                 
zie                 	zi                  
zien                	zin                 
ziet                	zit                 
zin                 	zIn                 
zingen              	zIN@n               
zingt               	zINt                
zinnen              	zIn@n               
zinnespeelingen     	zIn@sp@lIN@n        
zit                 	zIt                 
zitplaatzen         	zItpla:tz@n         
zitten              	zIt@n               
zittens             	zIt@ns              
zo                  	zo:                 
zocht               	zOxt                
zoek                	zuk                 
zoen                	zun                 
zoenen              	zun@n               
zoet                	zut                 
zoete               	zut@                
zoetjes             	zutj@s              
zomtyds             	zOmtIds             
zonlicht            	zOnlIxt             
zonneschynen        	zOn@sxin@n          
zoon                	zo:n                
zou                 	zAu                 
zoud                	zAut                
zouden              	zAud@n              
zouw                	zAuw                
zuigen              	z9yx@n              
zuipen              	z9yp@n              
zulk                	zYlk                
zulks               	zYlks               
zulleks             	zYl@ks              
zullen              	zYl@n               
zult                	zYlt                
zusje               	zYsj@               
zwaare              	zwa:r@              
zwaer               	zwa:r               
zwak                	zwAk                
zweer               	zw@r                
zweeren             	zw@r@n              
zweet               	zw@t                
zwelgen             	zw@lx@n             
zwichten            	zwIxt@n             
zwier               	zwir                
zwiertje            	zwirtj@             
zwoer               	zwur                
zwygen              	zwix@n              
zwygende            	zwix@nd@            
zy                  	zi                  
zyde                	zid@                
zyn                 	zin                 
zyne                	zin@                
zynen               	zin@n               
zyt                 	zit                 
