aria                	Aria:               	A*ria:              
arieus              	AriYs               	A*riYs              
orten               	Ort@n               	O*rt@n              
aakster             	a:kst@r             	a:kst@              
aanboren            	a:nbOr@n            	a:nbO*r@n           
aangaan             	a:nxa:n             	a:Na:n              
aangehoord          	a:ng@ho:rt          	a:N@ho:rt           
aanminnig           	a:nmInIx            	a:nmInIg            
abordeeren          	AbOrd@r@n           	AbO*rd@r@n          
abraham             	Abra:hAm            	AbrAhAm             
absurd              	AbsYrt              	AbsA*rt             
accorderen          	AkOrd@r@n           	AkO*rd@@n           
adder               	Ad@r                	Ad@                 
adjudiceeren        	AdjydIs@r@n         	AdjYdIk@r@n         
advocaat            	Advo:kAt            	AdvOkAt             
advocaaten          	Advo:kAt@n          	AdvOkAt@n           
advouëren          	Advu@r@n            	AdvAu@@n            
afeschuijert        	Af@sx9yj@rt         	Af@sx9yj@t          
after               	Aft@r               	Aft@                
agter               	Axt@r               	Axt@                
alberisper          	Alb@Isp@r           	Alb@Isp@            
alias               	AliAs               	Alia:s              
alibi               	Alibi               	AlIbi               
alleenig            	Al@nIx              	Al@nIg              
allerbest           	Al@rb@st            	Al@b@st             
amper               	Amp@r               	Amp@                
amsterdam           	Amst@rdAm           	Amst@dAm            
amsterdamsche       	Amst@rdAms@         	Amst@dAms@          
amsterdamse         	Amst@rdAms@         	Amst@dAms@          
ander               	And@r               	And@                
anderdeels          	And@rd@ls           	And@d@ls            
andere              	And@r@              	And@@               
anderen             	And@r@n             	And@@n              
anders              	And@rs              	And@s               
applicabel          	Applika:b@l         	ApplIkb@l           
appliceren          	Applis@r@n          	ApplIk@@n           
argeweeren          	Arx@w@r@n           	A*rx@w@r@n          
argumenten          	ArxYm@nt@n          	A*rxYm@nt@n         
aria                	Aria:               	A*ria:              
arm                 	Arm                 	A*rm                
arme                	Arm@                	A*rm@               
armen               	Arm@n               	A*rm@n              
armstoel            	Armstul             	A*rmstul            
assuransje          	AsyrAnsj@           	AsA*rAnsj@          
attestacies         	At@stAsis           	At@stAs@s           
attestacy           	At@stAsi            	At@stAs             
authoriseren        	Auto:rIs@r@n        	AutO*rIs@@n         
authoriteyt         	Auto:rItEit         	AutO*rIt@t          
avecaet             	Av@ka:t             	Av@k@t              
avocaet             	Avo:ka:t            	AvOk@t              
avocaeten           	Avo:ka:t@n          	AvOk@t@n            
baldaedigheden      	bAlda:dIxh@d@n      	bAlda:dIg@d@n       
bank                	bANk                	bAnk                
banken              	bANk@n              	bAnk@n              
barre               	bArr@               	bA*rr@              
bartholus           	bArto:lYs           	bA*rtOlYs           
basterd             	bAst@rt             	bAst@t              
batavia             	bAta:via:           	bAtAvia:            
bedanken            	b@dANk@n            	b@dAnk@n            
beduijen            	b@d9y@n             	b@d9yj@n            
beeker              	b@k@r               	b@k@                
beeter              	b@t@r               	b@t@                
bei                 	b@Ei                	b@                  
beid                	bEit                	b@t                 
beide               	bEid@               	b@d@                
beiden              	bEid@n              	b@d@n               
beijen              	bEi@n               	b@j@n               
bekommerd           	b@kOm@rt            	b@kOm@t             
benieuwt            	b@niyuwt            	b@niyut             
berg                	b@rx                	b@x                 
bergen              	b@rx@n              	b@x@n               
berger              	b@rx@r              	b@x@                
bescheid            	b@sxEit             	b@sx@It             
bescheiden          	b@sxEid@n           	b@sx@Id@n           
bestormen           	b@stOrm@n           	b@stO*rm@n          
beuken              	b2:k@n              	b@k@n               
beur                	b2:r                	b@r                 
beurs               	b2:rs               	b@rs                
beursesnijen        	b2:rs@sni@n         	b@rs@sni@n          
beurt               	b2:rt               	b@rt                
beuzelen            	b2:z@l@n            	b@z@l@n             
bewerken            	b@w@rk@n            	b@w@k@n             
bezonder            	b@zOnd@r            	b@zOnd@             
bibliotheecq        	bIblio:t@k          	bIblio:t@kk         
blaauw              	blAuw               	bla:w               
bloodshoofds        	blo:dsho:fds        	blo:dsjo:fds        
blyft               	blift               	blIft               
blyk                	blik                	blIk                
blyken              	blik@n              	blIk@n              
blykt               	blikt               	blIkt               
blyspeelen          	blisp@l@n           	blIsp@l@n           
blyspel             	blisp@l             	blIsp@l             
blyspellen          	blisp@l@n           	blIsp@l@n           
blyyen              	bli@n               	bliin               
bord                	bOrt                	bO*rt               
borst               	bOrst               	bO*rst              
boven               	bo:v@n              	bOv@n               
bovengemelde        	bo:v@nx@m@ld@       	bOv@@m@ld@          
bovenste            	bo:v@nst@           	bOv@nst@            
brengen             	br@N@n              	br@@n               
bruijen             	br9y@n              	br9yj@n             
bruy                	br9y                	brYi                
burgemiesters       	bYrx@mist@rs        	bA*rx@mist@s        
burger              	bYrx@r              	bA*rx@              
buur                	byr                 	byu@s               
buuren              	byr@n               	byu@sn              
buurman             	byrmAn              	byu@sAn             
byltje              	biltj@              	bIltj@              
bysonder            	bisOnd@r            	bisOnd@             
bysondere           	bisOnd@r@           	bisOnd@@            
byster              	bist@r              	bIst@               
bytje               	bitj@               	bItj@               
byzondere           	bizOnd@r@           	bizOnd@@            
byzonderlyk         	bizOnd@rlIk         	bizOnd@lIk          
cabas               	ka:bAs              	kbAs                
calangie            	ka:lANi             	klANi               
carel               	ka:r@l              	kr@l                
carels              	ka:r@ls             	kr@ls               
cas                 	kAs                 	ks                  
casus               	ka:sYs              	ksYs                
cat                 	kAt                 	kt                  
catje               	kAtj@               	ktj@                
cesserende          	s@s@r@nd@           	k@s@@nd@            
cobus               	ko:bYs              	kObYs               
commediant          	kOm@diAnt           	kOm@dia:nt          
communi             	kOmyni              	kOmYni              
comparatie          	kOmpA:ra:ti         	kOmpA*rAti          
concludeer          	kOnklyd@r           	kOnklYd@r           
conclusy            	kOnklysi            	kOnklYsi            
confrater           	kOnfra:t@r          	kOnfrAt@            
confrere            	kOnfr@r@            	kOnfr@@             
conjungeeren        	kOnjYnx@r@n         	kOnjAN@r@n          
consenteren         	kOns@nt@r@n         	kOns@nt@@n          
contrarie           	kOntra:ri           	kOntrA*ri           
contrary            	kOntra:ri           	kOntrA*ri           
converseerde        	kOnv@rs@rd@         	kOnv@s@rd@          
copye               	ko:pi               	kOpi                
coridon             	ko:ridOn            	kO*rIdOn            
couplet             	kupl@t              	kAupl@t             
cyteeren            	sit@r@n             	st@r@n              
dadvocaat           	dAdvo:ka:t          	dAdvOkAt            
dagen               	da:x@n              	dAx@n               
damon               	da:mOn              	dAmOn               
dander              	dAnd@r              	dAnd@               
dandere             	dAnd@r@             	dAnd@@              
darde               	dArd@               	dA*rd@              
darme               	dArm@               	dA*rm@              
darrem              	dArr@m              	dA*rr@m             
dartele             	dArt@l@             	dA*rt@l@            
dato                	da:to:              	dAto:               
davecaet            	dAv@ka:t            	dAv@k@t             
defloratie          	d@flo:rAti          	d@flO*rAti          
defloravit          	d@flo:ra:vIt        	d@flO*rAvIt         
deisch              	dEis                	d@s                 
deischer            	dEis@r              	d@sx@r              
denegatie           	d@n@xa:ti           	d@n@xAti            
der                 	d@r                 	d@                  
derde               	d@rd@               	d@d@                
deugd               	d2:xt               	d@xt                
deugden             	d2:xd@n             	d@xd@n              
deugdzaem           	d2:xdza:m           	d@xdza:m            
deun                	d2:n                	d@n                 
deur                	d2:r                	d@r                 
deurtrapt           	d2:rtrApt           	d@rtrApt            
dezer               	d@z@r               	d@z@                
dicam               	dikam               	dIkm                
didrik              	didrIk              	dIdrIk              
dienstbereiden      	dinstb@rEid@n       	dinstb@@d@n         
dieper              	dip@r               	dip@                
diminueeren         	diminy@r@n          	dImIny@@n           
dirk                	dIrk                	dI*rk               
discoreeren         	dIskOr@r@n          	dIskO*r@r@n         
discurreeren        	dIskyr@r@n          	dIskr@r@n           
dochter             	dOxt@r              	dOxt@               
dochters            	dOxt@rs             	dOxt@s              
donker              	dOnk@r              	dOnk@               
donnosle            	dOno:sl@            	dOnOsl@             
dorp                	dOrp                	dO*rp               
dreigt              	drEixt              	dr@xt               
droefheid           	drufhEit            	drufh@t             
drooger             	dro:x@r             	dro:x@              
drooghals           	dro:ghAls           	dro:gAls            
drygt               	drixt               	drIxt               
ducatons            	dykatOns            	dYktOns             
duiker              	d9yk@r              	d9yk@               
dupliceerende       	duplIs@r@nd@        	dYplIk@r@nd@        
duplycq             	dYplik              	dYplIkk             
durf                	dYrf                	dA*rf               
durven              	dYrv@n              	dA*rv@n             
dwars               	dwArs               	dwA*rs              
echt                	@xt                 	@t                  
echter              	@xt@r               	@t@                 
eener               	@n@r                	@n@                 
eerder              	@rd@r               	@rd@                
ei                  	Ei                  	@                   
eigen               	Eix@n               	@x@n                
einde               	Eind@               	@nd@                
eindelyk            	Eind@lIk            	@nd@lIk             
eindigt             	EindIxt             	@ndIxt              
eisch               	Eis                 	@s                  
eischer             	Eisx@r              	@sx@r               
eitje               	Eitj@               	@tj@                
elders              	@ld@rs              	@ld@s               
elucidatie          	@lysida:ti          	@lYsdAti            
eluijert            	@l9y@rt             	@l9yj@t             
encarel             	@nka:r@l            	@nkr@l              
encourageeren       	@nkurAZ@r@n         	@nkAurAx@r@n        
engelgraaff         	@N@lxra:f           	@@lxra:f            
er                  	@r                  	@                   
erfg                	@rfx                	@fx                 
etcaetera           	@ts@t@ra:           	@tk@t@a:            
excelent            	@ks@l@nt            	@k@l@nt             
exceptie            	@ks@pti             	@k@pti              
exemplaer           	@ks@mpla:r          	@@mpla:r            
exemplaren          	@ks@mplA*r@n        	@@mplA*r@n          
exhibeeren          	@kshib@r@n          	@hIb@r@n            
expensis            	@ksp@nsIs           	@p@nsIs             
expiratie           	@kspira:ti          	@pI*rAti            
expireren           	@kspir@r@n          	@pI*r@@n            
expres              	@kspr@s             	@pr@s               
expresselijk        	@kspr@s@lIk         	@pr@s@lIk           
extensie            	@kst@nsi            	@t@nsi              
ey                  	Ei                  	@                   
eygenaars           	Eix@na:rs           	@x@na:rs            
eynde               	Eind@               	@nd@                
fiat                	fiAt                	fia:t               
floreen             	flo:r@n             	flO*r@n             
fobert              	fOb@rt              	fOb@t               
foberts             	fOb@rts             	fOb@ts              
fondament           	fOnda:m@nt          	fOndAm@nt           
forma               	fOrma:              	fO*rma:             
formeel             	fOrm@l              	fO*rm@l             
frivol              	frivOl              	frIvOl              
fuyke               	f9yk@               	fYik@               
fyndoek             	finduk              	fInduk              
fynnen              	fin@n               	fIn@n               
fynste              	finst@              	fInst@              
geabbrevieerde      	x@Abr@vi@rd@        	x@br@vi@d@          
geaccordeert        	x@AkOrd@rt          	x@kO*rd@rt          
geannulleert        	x@AnYl@rt           	x@nYl@rt            
gebeuren            	x@b2:r@n            	x@b@r@n             
gebruycken          	x@br9yk@n           	x@brYIk@n           
geconditioneert     	x@kOnditio:n@rt     	x@kOndItio:n@rt     
gecontraheerde      	x@kOntra:h@rd@      	x@kOntrAh@rd@       
gedurende           	x@dyr@nd@           	x@dA*r@nd@          
geduurende          	x@dyr@nd@           	x@dyu@snd@          
geexamineert        	x@@ksa:min@rt       	x@ksAmIn@rt         
geflonker           	x@flOnk@r           	x@flOnk@            
gejouisseert        	x@Zuis@rt           	x@AuIs@rt           
gejuig              	x@j9yx              	x@9yx               
gekkekooy           	x@k@ko:i            	x@kk@ko:i           
geleerdheid         	x@l@rdhEit          	x@l@rdh@t           
gelyk               	x@lik               	x@lIk               
gelyken             	x@lik@n             	x@lIk@n             
gelykenis           	x@lik@nIs           	x@lIk@nIs           
gelykenissen        	x@lik@nIs@n         	x@lIk@nIs@n         
geoctroyeert        	x@Oktro:i@@rt       	x@ktro:i@@t         
gepeinzen           	x@pEinz@n           	x@p@nz@n            
gepermitteert       	x@p@rmIt@rt         	x@p@mIt@rt          
gepleit             	x@plEit             	x@pl@t              
geprocreert         	x@prOkr@@rt         	x@prOkr@rt          
geproduceerd        	x@pro:dys@rt        	x@prOdYk@rt         
gepromoveert        	x@pro:mo:v@rt       	x@prOmOv@rt         
gepurgeert          	x@pYrx@rt           	x@pA*rx@rt          
geraaden            	x@ra:d@n            	x@a:d@n             
geraaken            	x@ra:k@n            	x@a:k@n             
geraas              	x@ra:s              	x@a:s               
geraekt             	x@ra:kt             	x@a:kt              
gerard              	x@rArt              	x@A*rt              
gerecht             	x@r@xt              	x@@t                
gerechtskaamer      	x@r@xtska:m@r       	x@@tska:m@          
gereed              	x@r@t               	x@@t                
gereeden            	x@r@d@n             	x@@d@n              
gereegen            	x@r@x@n             	x@@x@n              
gerequireerdens     	x@r@kwir@rd@ns      	x@@kwI*r@rd@ns      
gerippereert        	x@rIpp@r@rt         	x@Ipp@@rt           
gerust              	x@rYst              	x@Yst               
gescheurt           	x@sx2:rt            	x@sx@A*rt           
gestort             	x@stOrt             	x@stO*rt            
gesubcenteert       	x@sYbs@nt@rt        	x@sYbk@nt@rt        
geurig              	x2:rIg              	x@rIg               
geurige             	x2:rIg@             	x@rIg@              
gezeid              	x@zEit              	x@z@t               
godshuisen          	xOdsh9ys@n          	xOdsj9ys@n          
godshuysen          	xOdsh9ys@n          	xOdsjYis@n          
goedwilligheid      	xudwIlIghEit        	xudwIlIg@t          
gratie              	xra:ti              	xrAti               
gratificeren        	xra:tIfIs@r@n       	xrAtIfIk@@n         
grypt               	xript               	xrIpt               
gunter              	xYnt@r              	xYnt@               
haamer              	ha:m@r              	ha:m@               
haamertje           	ha:m@rtj@           	ha:m@tj@            
hady                	ha:di               	hAdi                
hage                	ha:x@               	hAx@                
hamer               	ha:m@               	hAm@                
hard                	hArt                	hA*rt               
harde               	hArd@               	hA*rd@              
harder              	hArd@r              	hA*rd@              
harderwyk           	hArd@rwik           	hA*rd@wik           
hare                	ha:r@               	hA*r@               
haren               	ha:r@n              	hA*r@n              
harssendroomen      	hArs@ndro:m@n       	hA*rs@ndro:m@n      
harssens            	hArs@ns             	hA*rs@ns            
hart                	hArt                	hA*rt               
hartelyk            	hArt@lIk            	hA*rt@lIk           
harten              	hArt@n              	hA*rt@n             
hartseer            	hArts@r             	hA*rts@r            
heblykheid          	h@blIkhEit          	h@blIkh@t           
heid                	hEit                	h@t                 
heinsius            	hEinsiYs            	h@nsius             
henglen             	h@Nl@n              	h@l@n               
herberg             	h@rb@rx             	h@b@x               
herhaalen           	h@rha:l@n           	h@ha:l@n            
hervormen           	h@rvOrm@n           	h@vO*rm@n           
heunig              	h2:nIg              	h@nIg               
heur                	h2:r                	h@r                 
heurs               	h2:rs               	h@rs                
hoge                	ho:x@               	hOx@                
hola                	ho:la:              	hOla:               
homeris             	ho:m@rIs            	hOm@Is              
honderd             	hOnd@rt             	hOnd@t              
hondert             	hOnd@rt             	hOnd@t              
honig               	ho:nIg              	hOnIg               
huibert             	h9yb@rt             	h9yb@t              
huuwelyk            	hyw@lIk             	hyu@slIk            
huuwlyk             	hyw@lik             	hyu@sik             
huuwlyks            	hyw@lIks            	hyu@sIks            
huuwlykszaaken      	hyw@lIksza:k@n      	hyu@sIksza:k@n      
hyntje              	hintj@              	hIntj@              
immermeer           	Im@rm@r             	Im@m@r              
immers              	Im@rs               	Im@s                
impartinency        	ImpArtin@nsi        	ImpA*rtIn@ns        
impartinent         	ImpArtin@nt         	ImpA*rtIn@nt        
ingebragte          	Inx@brAxt@          	IN@brAxt@           
ingeleid            	Inx@lEit            	IN@l@t              
injungeeren         	InjYN@r@n           	InjAN@r@n           
inktkooker          	Inktko:k@r          	Inktko:k@           
irrelevant          	Ir@l@vAnt           	I*rr@l@vAnt         
irreprochabel       	Ir@prOxAb@l         	I*rr@prOxAb@l       
jacob               	ja:kOp              	jAkOp               
jacobus             	ja:kObYs            	jAkObYs             
jansz               	jAns                	jAnss               
jaren               	ja:r@n              	jA*r@n              
jer                 	j@r                 	j@                  
jeremias            	j@r@miAs            	j@@mia:s            
jeugd               	j2:xt               	j@xt                
jeugdig             	j2:xdIg             	j@xdIg              
joachimus           	joAximYs            	joAxImYs            
joan                	jo:An               	jo:a:n              
joannes             	jo:An@s             	joAn@s              
jonker              	jOnk@r              	jOnk@               
jorden              	jOrd@n              	jO*rd@n             
joris               	jOrIs               	jO*rIs              
kaamer              	ka:m@r              	ka:m@               
kaameraet           	ka:m@ra:t           	ka:m@a:t            
kaamerdeur          	ka:m@rd2:r          	ka:m@d@r            
kaeter              	ka:t@r              	ka:t@               
kamer               	ka:m@r              	kAm@                
kanjuweeltje        	kAnjyw@ltj@         	kAnjyu@@ltj@        
karel               	ka:r@l              	kA*r@l              
karsten             	kArst@n             	kA*rst@n            
keijers             	k@j@rs              	k@j@s               
keirel              	kEir@l              	k@r@l               
keunings            	k2:nINs             	k@nINs              
keuninklyk          	k2:nInklIk          	k@nInklIk           
keunje              	k2:nj@              	k@nj@               
kikvorschen         	kIkvOrs@n           	kIkvO*rsx@n         
kinders             	kInd@rs             	kInd@s              
klaarheid           	kla:rhEit           	kla:rh@t            
klaarleid           	kla:rlEit           	kla:rl@t            
klein               	klEin               	kl@n                
kleutergeld         	kl2:t@rx@lt         	kl@t@x@lt           
kluchten            	klYxt@n             	klAxt@n             
kluchtspel          	klYxtsp@l           	klAxtsp@l           
kneukels            	kn2:k@ls            	kn@k@ls             
knikkerbil          	knIkk@rbIl          	knIkk@bIl           
knorrepot           	knOrr@pOt           	knO*rr@pOt          
komen               	ko:m@n              	kOm@n               
komje               	ko:mj@              	kOmj@               
kort                	kOrt                	kO*rt               
kortswylige         	kOrtswilIg@         	kO*rtswilIg@        
kraamer             	kra:m@r             	kra:m@              
krioelen            	kriul@n             	krio:@l@n           
krygt               	krixt               	krIxt               
kryns               	krins               	krIns               
krynvaar            	krinva:r            	krInva:r            
kusschen            	kYs@n               	kYsx@n              
kwaaker             	kwa:k@r             	kwa:k@              
kwalyk              	kwa:lIk             	kwAlIk              
kykt                	kikt                	kIkt                
langer              	lAN@r               	lAN@                
lasteraar           	lAst@ra:r           	lAst@a:r            
latona              	la:to:na:           	lAtOna:             
lavement            	la:v@m@nt           	lAv@m@nt            
leeger              	l@x@r               	l@x@                
leendert            	l@nd@rt             	l@nd@t              
leever              	l@v@r               	l@v@                
lei                 	lEi                 	l@                  
leid                	lEit                	l@t                 
leijen              	lEi@n               	l@j@n               
leit                	lEit                	l@t                 
leonard             	l@o:nArt            	l@nA*rt             
leyden              	lEid@n              	l@d@n               
licenciaat          	lIks@nsia:t         	lIk@nsa:t           
liever              	liv@r               	liv@                
looper              	lo:p@r              	lo:p@               
lucht               	lYxt                	lAxt                
luchten             	lYxt@n              	lAxt@n              
luchtig             	lYxtIg              	lAxtIg              
luisenseaet         	l9ys@ns@a:t         	l9ys@ns@@t          
luister             	l9yst@r             	l9yst@              
lyk                 	lik                 	lIk                 
lykt                	likt                	lIkt                
maken               	ma:k@n              	mAk@n               
malkander           	mAlkAnd@r           	mAlkAnd@            
malkanderen         	mAlkAnd@r@n         	mAlkAnd@@n          
malkanderens        	mAlkAnd@r@ns        	mAlkAnd@@ns         
mannenhuys          	mAn@nh9ys           	mAn@nhYis           
materie             	ma:t@ri             	mAt@i               
matrimony           	ma:trimo:ni         	mAtrImOni           
meerder             	m@rd@r              	m@rd@               
meester             	m@st@r              	m@st@               
meesters            	m@st@rs             	m@st@s              
meeters             	m@t@rs              	m@t@s               
meid                	mEit                	m@t                 
meisje              	mEisj@              	m@sj@               
meisjes             	mEisj@s             	m@sj@s              
menageeren          	m@na:Z@r@n          	m@nAx@r@n           
menschen            	m@ns@n              	m@nsx@n             
merken              	m@rk@n              	m@k@n               
meug                	m2:x                	m@x                 
meugje              	m2:xj@              	m@xj@               
meugt               	m2:xt               	m@xt                
minder              	mInd@r              	mInd@               
mitsgaders          	mItsxa:d@rs         	mItsxAd@s           
mitsgarder          	mItsxa:rd@r         	mItsxA*rd@          
mogen               	mo:x@n              	mOx@n               
mogten              	mo:xt@n             	mOxt@n              
morgen              	mOrx@n              	mO*rx@n             
morgens             	mOrx@ns             	mO*rx@ns            
mortje              	mOrtj@              	mO*rtj@             
mostert             	mOst@rt             	mOst@t              
murruwer            	mYrryw@r            	mA*rryu@r           
murw                	mYrw                	mA*rw               
musicaale           	mysika:l@           	mYsIkAl@            
myner               	min@r               	min@                
myns                	mins                	mIns                
naajen              	na:j@n              	na:i@n              
nagel               	na:x@l              	nAx@l               
narree              	na:r@               	nA*rr@              
naspreekende        	na:spr@k@nd@        	nAspr@k@nd@         
nederigheid         	n@d@rIghEit         	n@d@Ig@t            
neus                	n2:s                	n@s                 
neusdoek            	n2:sduk             	n@sduk              
neutekraaker        	n2:t@kra:k@         	n@t@kra:k@          
neuten              	n2:t@n              	n@t@n               
notaris             	no:ta:rIs           	nOtA*rIs            
november            	nOv@mb@r            	nOv@mb@             
nuyts               	n9yts               	nYIts               
officier            	Ofisir              	OfIs@               
onder               	Ond@r               	Ond@                
onderdanig          	Ond@rdAnIg          	Ond@dAnIg           
onderschryven       	Ond@rsxriv@n        	Ond@sxriv@n         
onderst             	Ond@rst             	Ond@st              
ondertusschen       	Ond@rtYs@n          	Ond@tYsx@n          
ondervonden         	Ond@rvOnd@n         	Ond@vOnd@n          
onderweeg           	Ond@rw@x            	Ond@w@x             
onderwerp           	Ond@rw@rp           	Ond@w@p             
onderwinden         	Ond@rwInd@n         	Ond@wInd@n          
onderwylen          	Ond@rwil@n          	Ond@wil@n           
ongderhouwen        	ONd@rhAuw@n         	ONd@hAuw@n          
ongevraagd          	ON@rvra:xt          	ON@vra:xt           
onthoud             	OnthAut             	OntAut              
ontkleed            	OntklEit            	Ontkl@t             
opereeren           	Op@r@r@n            	Op@@r@n             
opgeschort          	Opx@sxOrt           	Opx@sxO*rt          
opmerking           	Opm@rkIN            	Opm@kIN             
oprecht             	Opr@xt              	Opr@t               
oprechtende         	Opr@xt@nd@          	Opr@t@nd@           
ordinary            	Ordina:ri           	O*rdInA*ri          
ordonnantie         	OrdOnAnti           	O*rdOnAnti          
ordonneeren         	OrdOn@r@n           	O*rdOn@r@n          
oreeren             	o:r@r@n             	O*r@r@n             
ouderloose          	Aud@rlo:s@          	Aud@lo:s@           
over                	Ov@r                	Ov@                 
overboodig          	Ov@rbo:dIg          	Ov@bo:dIg           
overende            	Ov@r@nd@            	Ov@@nd@             
overgemerckt        	Ov@rx@m@rkt         	Ov@x@m@kt           
overlang            	Ov@rlAN             	Ov@lAN              
overleggen          	Ov@rl@x@n           	Ov@l@x@n            
overluid            	Ov@rl9yt            	Ov@l9yt             
overschaduwen       	Ov@rsxAdyu@n        	Ov@sxAdyu@n         
overslaan           	Ov@rsla:n           	Ov@sla:n            
overweegen          	Ov@rw@x@n           	Ov@w@x@n            
paciensy            	pAsi@nsi            	pAs@nsi             
pacquet             	pAkk@t              	pAkkw@t             
part                	pArt                	pA*rt               
parthy              	pArti               	pA*rti              
parthyen            	pArti@n             	pA*rtin             
parthys             	pArtis              	pA*rtis             
particulier         	pArtikylir          	pA*rtIklir          
party               	pArti               	pA*rti              
partyen             	pArti@n             	pA*rtin             
peis                	pEis                	p@s                 
periode             	p@rio:d@            	p@io:d@             
persisteeren        	p@rsIst@r@n         	p@sIst@r@n          
peur                	p2:r                	p@r                 
peurd               	p2:rt               	p@rt                
phlegmatiecq        	phl@xmAtik          	phl@xmAtikk         
pieter              	pit@r               	pit@                
pinkster            	pInkst@r            	pInkst@             
pleidooijeeren      	plEido:i@r@n        	pl@do:i@r@n         
pleidooijen         	plEido:i@n          	pl@do:i@n           
pleidooy            	plEido:i            	pl@do:i             
pleidoyeeren        	plEido:i@r@n        	pl@do:i@@@n         
pleit               	plEit               	pl@t                
pleiten             	plEit@n             	pl@t@n              
pleiters            	plEit@rs            	pl@t@s              
pleitrok            	plEitrOk            	pl@trOk             
pleitzak            	pleitzAk            	pl@tzAk             
pluimer             	pl9ym@r             	pl9ym@              
poëtiecque         	po:@tik@            	putikkw@            
praater             	pra:t@r             	pra:t@              
precautioneel       	pr@kAutio:n@l       	pr@kYtio:n@l        
prepareeren         	pr@pa:r@r@n         	pr@pA*r@r@n         
presentacy          	pr@s@ntasi          	pr@s@ntAs           
president           	pr@sid@nt           	pr@sId@nt           
presidents          	pr@sid@nts          	pr@sId@nts          
preutse             	pr2:ts@             	pr@ts@              
prezident           	pr@zid@nt           	pr@zId@nt           
primis              	primIs              	prImIs              
primo               	primo:              	prImo:              
privilegie          	privil@Zi           	prIvIl@xi           
probeeren           	pro:b@r@n           	prOb@r@n            
procedant           	pro:s@dAnt          	prOk@dAnt           
proces              	pro:s@s             	prOk@s              
processe            	pro:s@s@            	prOk@s@             
procureurs          	pro:kyr2:rs         	prOkr@rs            
produceeren         	pro:dys@r@n         	prOdYk@r@n          
prolix              	pro:lIks            	prOlIks             
prolongatie         	pro:lONa:ti         	prOlONAti           
pronuncieeren       	pro:nYnsi@r@n       	prOnYns@r@n         
protextie           	prOt@kti            	prOt@ti             
prykt               	prikt               	prIkt               
prytje              	pritj@              	prItj@              
publyk              	pyblik              	pYblIk              
puiterveen          	p9yt@rv@n           	p9yt@v@n            
puiterveenen        	p9yt@rv@n@n         	p9yt@v@n@n          
puur                	pyr                 	pyu@s               
qualitate           	kwa:lita:t@         	kwAlItAt@           
qualiteit           	kwa:litEit          	kwAlIt@t            
qualiteyt           	kwa:litEit          	kwAlIt@t            
quartus             	kwArtYs             	kwA*rtYs            
rangeeren           	rAnZ@r@n            	rAN@r@n             
rapsody             	rApso:di            	rApsOdi             
recht               	r@xt                	r@t                 
rechtbank           	r@xtbAnk            	r@tbAnk             
rechtbankzaamen     	r@xtbAnkza:m@n      	r@tbAnkza:m@n       
rechte              	r@xt@               	r@t@                
rechten             	r@xt@n              	r@t@n               
rechter             	r@xt@r              	r@t@                
rechters            	r@xt@rs             	r@t@s               
rechthuis           	r@xth9ys            	r@t9ys              
rechts              	r@xts               	r@ts                
rechtsgeding        	r@xtsx@dIN          	r@tsx@dIN           
rechtsgedingen      	r@xtsx@dIN@n        	r@tsx@dIN@n         
rechtsgeleerden     	r@xtsx@l@rd@n       	r@tsx@l@rd@n        
rechtskaamer        	r@xtska:m@          	r@tska:m@           
recitatief          	r@sita:tif          	r@stAtif            
refuseeren          	r@fys@r@n           	r@fYs@r@n           
reinigen            	rEinIx@n            	r@nIx@n             
reis                	rEis                	r@s                 
reparatie           	r@pa:ra:ti          	r@pA*rAti           
repliceerende       	r@plis@r@nd@        	r@plIk@r@nd@        
replycq             	r@plik              	r@plIkk             
reputatie           	r@pyta:ti           	r@pYtAti            
requirant           	r@kwirAnt           	r@kwI*rAnt          
respective          	r@sp@ktiv@          	r@sp@ktIv@          
resterende          	r@st@r@nd@          	r@st@@nd@           
resumeeren          	r@sym@r@n           	r@sYm@r@n           
ruchtbaer           	rYxtba:r            	rAxtba:r            
ryksdaalders        	rIksda:ld@rs        	rIksda:ld@s         
salaris             	sa:la:rIs           	sAlA*rIs            
samen               	sa:m@n              	sAm@n               
sandlooper          	sAndlo:p@r          	sAndlo:p@           
schabieus           	sxa:bi2:s           	sxAbiYs             
schabreuse          	sxa:br2:s@          	sxAbr@s@            
schade              	sxa:d@              	sxAd@               
schampere           	sxAmp@r@            	sxAmp@@             
scharrebier         	sxArr@bir           	sxA*rr@bir          
scheelden           	sx@ld@n             	sx@@ld@n            
scheelen            	sx@l@n              	sx@@l@n             
scheelt             	sx@lt               	sx@@lt              
scheepens           	sx@p@ns             	sx@@p@ns            
scheeren            	sx@@n               	sx@@@n              
scheijen            	sxEi@n              	sx@i@n              
schelmerijen        	sx@lm@rEi@n         	sx@lm@i@n           
scheuren            	sx@2:r@n            	sx@A*r@n            
scheurt             	sx@2:rt             	sx@A*rt             
scheystok           	sxEistOk            	sx@IstOk            
schoonder           	sxo:nd@r            	sxo:nd@             
schooon             	sxo:n               	sxo:On              
schoothondjen       	sxo:thOndj@n        	sxo:tOndj@n         
schort              	sxOrt               	sxO*rt              
schouburg           	sxAubYrx            	sxAubA*rx           
schouderen          	sxAud@r@n           	sxAud@@n            
schouwburg          	sxAuwbYrx           	sxAuwbA*rx          
schreeuwt           	sxre:ut             	sxr@yut             
schreit             	sxrEit              	sxr@t               
schriftuur          	sxrIftyr            	sxrIftyu@s          
schriftuuren        	sxrIftyr@n          	sxrIftyu@sn         
schuur              	sxyr                	sxyu@s              
schuuren            	sxyr@n              	sxyu@sn             
secretaris          	s@kr@ta:rIs         	s@kr@tA*rIs         
sedert              	s@d@rt              	s@d@t               
seeckere            	s@k@r@              	s@k@@               
seemelknooper       	s@m@lkno:p@r        	s@m@lkno:p@         
seun                	s2:n                	s@n                 
singulier           	sINylir             	sINYlir             
slachter            	slAxt@r             	slAxt@              
slampamper          	slAmpAmp@r          	slAmpAmp@           
slechjes            	sl@xj@s             	sl@j@s              
slecht              	sl@xt               	sl@t                
slechten            	sl@xt@n             	sl@t@n              
slechts             	sl@xts              	sl@ts               
snoepreisje         	snuprEisj@          	snupr@sj@           
snotneus            	snOtn2:s            	snOtn@s             
snyders             	snid@rs             	snid@s              
soerce              	surs@               	surk@               
soetert             	sut@rt              	sut@t               
sondament           	sOnda:m@nt          	sOndAm@nt           
sonder              	sOnd@r              	sOnd@               
soomers             	so:m@rs             	so:m@s              
souveraine          	suv@rAin@           	sAuv@Ain@           
speult              	sp2:lt              	sp@lt               
staten              	sta:t@n             	stAt@n              
statu               	sta:ty              	stAty               
statueeren          	sta:ty@r@n          	stAty@@n            
sterken             	st@rk@n             	st@k@n              
sterkste            	st@rkst@            	st@kst@             
steune              	st2:n@              	st@n@               
stort               	stOrt               	stO*rt              
student             	styd@nt             	stYd@nt             
supplianten         	sYppliAnt@n         	sYpplia:nt@n        
teder               	t@d@r               	t@d@                
teedere             	t@d@r@              	t@d@@               
teisteren           	tEist@r@n           	t@st@@n             
ter                 	t@r                 	t@                  
termineeren         	t@rmin@r@n          	t@mIn@r@n           
terwel              	t@rw@l              	t@w@l               
terwyl              	t@rwil              	t@wil               
textum              	t@xtYm              	t@tYm               
thyrcis             	tIrsIs              	tIrss               
toehoorders         	tuho:rd@rs          	tuho:rd@s           
tonderdrukken       	tOnd@drYk@n         	tOnd@drYkk@n        
tontveinzen         	tOntvEinz@n         	tOntv@nz@n          
tooneelwerken       	to:n@lw@rk@n        	to:n@lw@k@n         
treuren             	tr2:r@n             	tr@r@n              
treurpellen         	tr2:rp@l@n          	tr@rp@l@n           
treurspellen        	tr2:rsp@l@n         	tr@rsp@l@n          
turf                	tYrf                	tA*rf               
turfmand            	tYrfmAnt            	tA*rfmAnt           
tusschen            	tYs@n               	tYsx@n              
tyds                	tids                	tIds                
tyjen               	ti@n                	tij@n               
uitgeleid           	9ytx@lEit           	9ytx@l@t            
uitstorten          	9ytstOrt@n          	9ytstO*rt@n         
universiteyt        	Yniv@rsitEit        	YnIv@sIt@t          
uur                 	yr                  	yu@s                
uuren               	yr@n                	yu@sn               
uurtje              	yr@tj@              	yu@sj@              
uyt                 	9yt                 	Yit                 
uytgeven            	9ytx@v@n            	YItx@v@n            
vader               	vAd@r               	vAd@                
vanbeaumont         	vAnb@o:mOnt         	vAnb@YmOnt          
vander              	vAnd@r              	vAnd@               
varken              	vArk@n              	vA*rk@n             
varkenskot          	vArk@nskOt          	vA*rk@nskOt         
vechten             	v@xt@n              	v@t@n               
veeters             	v@t@rs              	v@t@s               
veinsen             	vEins@n             	v@ns@n              
veinsende           	vEins@nd@           	v@ns@nd@            
venster             	v@nst@r             	v@nst@              
vensters            	v@nst@rs            	v@nst@s             
ver                 	v@r                 	v@                  
veranderd           	v@rAnd@rt           	v@And@t             
verandering         	v@rAnd@rIN          	v@And@IN            
verantwoorden       	v@rAntwo:rd@n       	v@Antwo:rd@n        
verbeeld            	v@rb@lt             	v@b@lt              
verbeeldeenig       	v@rb@ld@nIg         	v@b@ld@nIg          
verbeeterhuis       	v@rb@t@rh9ys        	v@b@t@h9ys          
verbeuren           	v@rb2:r@n           	v@b@r@n             
verbeurte           	v@rb2:rt@           	v@b@rt@             
verbiedende         	v@rbid@nd@          	v@bid@nd@           
verblommen          	v@rblOm@n           	v@blOm@n            
verbod              	v@rbOt              	v@bOt               
verboôn            	v@rbo:n             	v@bo:n              
verbrot             	v@rbrOt             	v@brOt              
verbruid            	v@rbr9yt            	v@br9yt             
verdedigen          	v@rd@dIx@n          	v@d@dIx@n           
verder              	v@rd@r              	v@d@                
verdicht            	v@rdIxt             	v@dIxt              
verdichte           	v@rdIxt@            	v@dIxt@             
verdrenken          	v@rdr@nk@n          	v@dr@nk@n           
verdwynen           	v@rdwin@n           	v@dwin@n            
vereerde            	v@r@rd@             	v@@rd@              
vereering           	v@r@rIN             	v@@rIN              
vereischt           	v@rEist             	v@@sxt              
vergaaderd          	v@rxa:d@rt          	v@xa:d@t            
vergaderd           	v@rxAd@rt           	v@xAd@t             
vergeeten           	v@rx@t@n            	v@x@t@n             
vergult             	v@rxYlt             	v@xYlt              
vergund             	v@rxYnt             	v@xYnt              
verhaal             	v@rha:l             	v@ha:l              
verhoedinge         	v@rhudIN@           	v@hudIN@            
verhoên            	v@rhun              	v@hun               
verhoole            	v@rho:l@            	v@ho:l@             
verhoolen           	v@rho:l@n           	v@ho:l@n            
verhoopende         	v@rho:p@nd@         	v@ho:p@nd@          
verhoor             	v@rho:r             	v@ho:r              
verifieeren         	v@rIfi@r@n          	v@Ifi@@n            
verkeerd            	v@rk@rt             	v@k@rt              
verkeert            	v@rk@rt             	v@k@rt              
verkiesen           	v@rkis@n            	v@kis@n             
verklaard           	v@rkla:rt           	v@kla:rt            
verklaaren          	v@rkla:r@n          	v@kla:r@n           
verklaaring         	v@rkla:rIN          	v@kla:rIN           
verklaring          	v@rkla:rIN          	v@klA*rIN           
verkogte            	v@rkOxt@            	v@kOxt@             
verkoopen           	v@rko:p@n           	v@ko:p@n            
verkopen            	v@rkOp@n            	v@kOp@n             
verkort             	v@rkOrt             	v@kO*rt             
verlaat             	v@rla:t             	v@la:t              
verlaaten           	v@rla:t@n           	v@la:t@n            
verlaatende         	v@rla:t@nd@         	v@la:t@nd@          
verlaeten           	v@rla:t@n           	v@la:t@n            
verlang             	v@rlAN              	v@lAN               
verleegen           	v@rl@x@n            	v@l@x@n             
verleenen           	v@rl@n@n            	v@l@n@n             
verleent            	v@rl@nt             	v@l@nt              
verleeren           	v@rl@r@n            	v@l@r@n             
verlichten          	v@rlIxt@n           	v@lIxt@n            
verliefde           	v@rlifd@            	v@lifd@             
verliesen           	v@rlis@n            	v@lis@n             
verliezen           	v@rliz@n            	v@liz@n             
verlijen            	v@rli@n             	v@li@n              
verloope            	v@rlo:p@            	v@lo:p@             
verlooren           	v@rlo:r@n           	v@lo:r@n            
vermaak             	v@rma:k             	v@ma:k              
vermaek             	v@rma:k             	v@ma:k              
vermeeren           	v@rm@r@n            	v@m@r@n             
vermits             	v@rmIts             	v@mIts              
vermogen            	v@rmOx@n            	v@mOx@n             
vermooren           	v@rmo:r@n           	v@mo:r@n            
verplicht           	v@rplIxt            	v@plIxt             
verschiet           	v@rsxit             	v@sxit              
verschil            	v@rsxIl             	v@sxIl              
versjerde           	v@rsj@rd@           	v@sj@d@             
versmelt            	v@rsm@lt            	v@sm@lt             
versoek             	v@rsuk              	v@suk               
versoekende         	v@rsuk@nd@          	v@suk@nd@           
versoope            	v@rso:p@            	v@so:p@             
verspreijen         	v@rsprEi@n          	v@spr@j@n           
verstaaje           	v@rsta:i@           	v@sta:i@            
verstaan            	v@rsta:n            	v@sta:n             
verstaat            	v@rsta:t            	v@sta:t             
verstaeje           	v@rsta:j@           	v@sta:j@            
verstaen            	v@rsta:n            	v@sta:n             
verstaet            	v@rsta:t            	v@sta:t             
verstand            	v@rstAnt            	v@stAnt             
verstande           	v@rstAnd@           	v@stAnd@            
verstommen          	v@rstOm@n           	v@stOm@n            
verstooren          	v@rsto:r@n          	v@sto:r@n           
verstreeken         	v@rstr@k@n          	v@str@k@n           
versuffen           	v@rsYf@n            	v@sYf@n             
vertoond            	v@rto:nt            	v@to:nt             
vertoonen           	v@rto:n@n           	v@to:n@n            
vertooners          	v@rto:n@rs          	v@to:n@s            
vertoont            	v@rto:nt            	v@to:nt             
vertrekken          	v@rtr@kk@n          	v@tr@kk@n           
vertrokken          	v@rtrOkk@n          	v@trOkk@n           
vertrouw            	v@rtrAuw            	v@trAuw             
vertrouwen          	v@rtrAuw@n          	v@trAuw@n           
verveelt            	v@rv@lt             	v@v@lt              
verwarring          	v@rwArrIN           	v@wA*rrIN           
verwyt              	v@rwit              	v@wit               
verwyten            	v@rwit@n            	v@wit@n             
verzachten          	v@rzAxt@n           	v@zAxt@n            
verzeekerd          	v@rz@k@rt           	v@z@k@t             
verzetten           	v@rz@t@n            	v@z@t@n             
verzoek             	v@rzuk              	v@zuk               
verzorgt            	v@rzOrxt            	v@zO*rxt            
veur                	v2:r                	v@r                 
vischryk            	vIsrik              	vIsxrik             
vleijen             	vlEi@n              	vl@j@n              
vleu                	vl2:                	vl@                 
vlucht              	vlYxt               	vlAxt               
voddery             	vOd@ri              	vOd@i               
volkomentlyk        	vOlko:m@ntlIk       	vOlkOm@ntlIk        
voorsz              	vo:rs               	vo:rss              
voorzeeker          	vo:rz@k@r           	vo:rz@k@            
vorder              	vOrd@r              	vO*rd@              
vorsten             	vOrst@n             	vO*rst@n            
vreemdigheid        	vr@mdIghEit         	vr@mdIg@t           
vreijen             	vrEi@n              	vr@j@n              
vreijer             	vrEi@r              	vr@j@               
vreijers            	vrEi@rs             	vr@j@s              
vreugd              	vr2:xt              	vr@xt               
vreugde             	vr2:xd@             	vr@xd@              
vrijerlyken         	vri@rlIk@n          	vri@lIk@n           
vrijers             	vri@rs              	vri@s               
vrucht              	vrYxt               	vrAxt               
vruchtbaer          	vrYxtba:r           	vrAxtba:r           
vryheid             	vrihEit             	vrih@t              
vryster             	vrIst@r             	vrIst@              
vrysters            	vrIst@rs            	vrIst@s             
vyfde               	vifd@               	vIfd@               
vyftien             	viftin              	vIftin              
waergenomen         	wa:rx@no:m@n        	wa:rx@nOm@n         
wakker              	wAkk@r              	wAkk@               
waren               	wa:r@n              	wA*r@n              
warm                	wa:rm               	wA*rm               
warme               	wa:rm@              	wA*rm@              
water               	wAt@r               	wAt@                
waters              	wAt@rs              	wAt@s               
weder               	w@d@r               	w@d@                
wederga             	w@d@rxa:            	w@d@xa:             
wederhouden         	w@d@rhAud@n         	w@d@hAud@n          
wederleggen         	w@d@rl@x@n          	w@d@l@x@n           
wederlegging        	w@d@rl@xIN          	w@d@l@xIN           
wedervraagen        	w@d@rvra:x@n        	w@d@vra:x@n         
wederzyde           	w@d@rzid@           	w@d@zid@            
wederzyds           	w@d@rzIds           	w@d@zIds            
weerparthy          	w@rpArti            	w@rpA*rti           
weeshuis            	w@sh9ys             	w@sj9ys             
weeshuys            	w@sh9ys             	w@sjYis             
wer                 	w@r                 	w@                  
wercken             	w@rk@n              	w@k@n               
werd                	w@rt                	w@t                 
werden              	w@rd@n              	w@d@n               
werdende            	w@rd@nd@            	w@d@nd@             
werk                	w@rk                	w@k                 
werken              	w@rk@n              	w@k@n               
werkje              	w@rkj@              	w@kj@               
winter              	wInt@r              	wInt@               
woekeraar           	wuk@ra:r            	wuk@a:r             
wonder              	wOnd@r              	wOnd@               
word                	wOrt                	wO*rt               
worden              	wOrd@n              	wO*rd@n             
wordend             	wOrd@nt             	wO*rd@nt            
wordende            	wOrd@nd@            	wO*rd@nd@           
wordje              	wOrdj@              	wO*rdj@             
worreld             	wOrr@lt             	wO*rr@lt            
wurm                	wYrm                	wA*rm               
wyders              	wid@rs              	wid@s               
wyzer               	wiz@r               	wiz@                
yder                	id@r                	id@                 
yverig              	iv@rIg              	iv@Ig               
zachter             	zAxt@r              	zAxt@               
zaligmakers         	zAlIxmAk@rs         	zAlIxmAk@s          
zeeker              	z@k@r               	z@k@                
zeeper              	z@p@r               	z@p@                
zei                 	zEi                 	z@                  
zeid                	zEit                	z@t                 
zeit                	zEit                	z@t                 
zelver              	z@lv@r              	z@lv@               
zeun                	z2:n                	z@n                 
zeunen              	z2:n@n              	z@n@n               
zieter              	zit@r               	zit@                
zodaanige           	zo:da:nIg@          	zOda:nIg@           
zonder              	zOnd@r              	zOnd@               
zonderling          	zOnd@rlIN           	zOnd@lIN            
zorg                	zOrx                	zO*rx               
zucht               	zYxt                	zAxt                
zuchtende           	zYxt@nd@            	zAxt@nd@            
zuikerbroodshoed    	z9yk@rbro:dshut     	z9yk@bro:dsjut      
zwaarigheid         	zwa:rIghEit         	zwa:rIg@t           
zwarigheid          	zwa:rIghEit         	zwA*rIg@t           
zwart               	zwArt               	zwA*rt              
zynd                	zint                	zInt                
zynde               	zind@               	zInd@               
