aria                	Aria:              
arieus              	AriYs              
nu                  	ny                  
onfangt             	OnfANt              
orten               	Ort@n              
wat                 	wAt                 
aakster             	a:kst@r              
aal                 	a:l                 
aan                 	a:n                 
aanboren            	a:nbOr@n           
aandacht            	a:ndAxt             
aandachtig          	a:ndAxtIg           
aandoen             	a:ndun              
aangaan             	a:nxa:n              
aangehoord          	a:ng@ho:rt           
aanhooren           	a:nho:r@n           
aanmaatige          	a:nma:tIg@          
aanminnig           	a:nmInIx            
aanneemen           	a:n@m@n             
aanschouwen         	a:nsxAuw@n          
aanschouwers        	a:nsxAuw@rs         
aansien             	a:nsin              
aanstonds           	a:nstOnds           
aanstootelyks       	a:nsto:t@lIks       
aar                 	a:r                 
aardig              	a:rdIg              
aars                	a:rs                
aart                	a:rt                
aasem               	a:s@m               
abordeeren          	AbOrd@r@n          
abraham             	Abra:hAm             
absurd              	AbsYrt             
accedemy            	Ak@d@mi             
accoord             	Ako:rt              
accorderen          	AkOrd@r@n           
ach                 	Ax                  
acht                	Axt                 
achten              	Axt@n               
achter              	Axt@                
achtste             	Axtst@              
ad                  	At                  
adder               	Ad@r                 
adjudiceeren        	AdjydIs@r@n         
adstrucsy           	AdstrYksi           
advers              	Adv@s               
advocaat            	Advo:kAt             
advocaaten          	Advo:kAt@n           
advouëren          	Advu@r@n            
aen                 	a:n                 
aenzien             	a:nzin              
aer                 	a:r                 
aerdig              	a:rdIg              
aert                	a:rt                
aertje              	a:rtj@              
aêl                	a:l                 
aêr                	a:r                 
aêrs               	a:rs                
af                  	Af                  
afbyten             	Afbit@n             
afeschuijert        	Af@sx9yj@rt          
afgedaan            	Afx@da:n            
afgeschroffeld      	Afx@sxrOf@lt        
afgesteeken         	Afx@st@k@n          
afkaatsen           	Afka:ts@n           
aftemeeten          	Aft@m@t@n           
after               	Aft@r                
aftestryken         	Aft@strik@n         
ageeren             	Ax@r@n              
agter               	Axt@r                
al                  	Al                  
alberisper          	Alb@Isp@r            
aldaar              	Alda:r              
aldien              	Aldin               
aldus               	AldYs               
alewijn             	Al@win              
alewyn              	Al@win              
algemeen            	Alx@m@n             
alias               	AliAs              
alibi               	Alibi               
all                 	Al                  
alle                	Al@                 
alleen              	Al@n                
alleenig            	Al@nIx              
alleman             	Al@mAn              
allen               	Al@n                
allerbest           	Al@rb@st             
alles               	Al@s                
allien              	Alin                
alls                	Als                 
alrieds             	Alrids              
als                 	Als                 
alsoo               	Also:               
altegaer            	Alt@xa:r            
althans             	AltAns              
altoos              	Alto:s              
altyd               	Altit               
alwaar              	Alwa:r              
amper               	Amp@r                
amsteldam           	Amst@ldAm           
amsterdam           	Amst@rdAm            
amsterdamsche       	Amst@rdAms@          
amsterdamse         	Amst@rdAms@          
ander               	And@r                
anderdeels          	And@rd@ls            
andere              	And@r@               
anderen             	And@r@n              
anders              	And@rs               
angst               	ANst                
anne                	An@                 
antwoord            	Antwo:rt            
applicabel          	Applika:b@l           
appliceren          	Applis@r@n           
april               	AprIl               
argeweeren          	Arx@w@r@n          
argumenten          	ArxYm@nt@n         
aria                	Aria:              
arm                 	Arm                
arme                	Arm@               
armen               	Arm@n              
armstoel            	Armstul            
as                  	As                  
asia                	Asia:               
assuransje          	AsyrAnsj@          
attestacies         	At@stAsis           
attestacy           	At@stAsi             
attesteeren         	At@st@r@n           
aut                 	Aut                 
authoriseren        	Auto:rIs@r@n         
authoriteyt         	Auto:rItEit          
avecaet             	Av@ka:t              
avocaet             	Avo:ka:t              
avocaeten           	Avo:ka:t@n            
avond               	AvOnt               
baalde              	ba:ld@              
baaren              	ba:r@n              
baeren              	ba:r@n              
bagatellen          	bAxAt@l@n           
bak                 	bAk                 
bakkes              	bAkk@s              
baldaedigheden      	bAlda:dIxh@d@n       
baldus              	bAldYs              
balken              	bAlk@n              
ballen              	bAl@n               
balsem              	bAls@m              
bank                	bANk                
banken              	bANk@n              
barre               	bArr@              
bartholus           	bArto:lYs           
bassen              	bAs@n               
basterd             	bAst@rt              
bastonneeren        	bAstOn@r@n          
batavia             	bAta:via:            
bed                 	b@t                 
bedaar              	b@da:r              
bedaard             	b@da:rt             
bedanken            	b@dANk@n            
bede                	b@d@                
bedenken            	b@d@nk@n            
bedieden            	b@did@n             
bedot               	b@dOt               
bedotten            	b@dOt@n             
bedrooge            	b@dro:x@            
bedroogen           	b@dro:x@n           
bedryf              	b@drif              
bedryten            	b@drit@n            
bedryven            	b@driv@n            
beduijen            	b@d9y@n            
beduit              	b@d9yt              
beeker              	b@k@r                
beelt               	b@lt                
been                	b@n                 
beest               	b@st                
beeter              	b@t@r                
bef                 	b@f                 
begaan              	b@xa:n              
begeerende          	b@x@r@nd@           
begin               	b@xIn               
beginnen            	b@xIn@n             
begint              	b@xInt              
begraaven           	b@xra:v@n           
begrypen            	b@xrip@n            
behalven            	b@hAlv@n            
behandeld           	b@hAnd@lt           
behoesten           	b@hust@n            
behoord             	b@ho:rt             
behooren            	b@ho:r@n            
behoorlyk           	b@ho:rlIk           
behoort             	b@ho:rt             
bei                 	b@Ei                  
beid                	bEit                 
beide               	bEid@                
beiden              	bEid@n               
beijen              	bEi@n               
bek                 	b@k                 
bekeeven            	b@k@v@n             
beken               	b@k@n               
bekend              	b@k@nt              
bekenden            	b@k@nd@n            
bekennen            	b@k@n@n             
bekent              	b@k@nt              
beklaaglyke         	b@kla:xlIk@         
beklat              	b@klAt              
beknopt             	b@knOpt             
bekommerd           	b@kOm@rt             
bekyken             	b@kik@n             
belaaden            	b@la:d@n            
belaagen            	b@la:x@n            
belaên             	b@la:n              
beleedigen          	b@l@dIx@n           
beleezen            	b@l@z@n             
belet               	b@l@t               
beletten            	b@l@t@n             
bellen              	b@l@n               
beloft              	b@lOft              
beloof              	b@lo:f              
beloofd             	b@lo:ft             
beloofje            	b@lo:fj@            
belooft             	b@lo:ft             
belooven            	b@lo:v@n            
bemind              	b@mInt              
ben                 	b@n                 
benevens            	b@n@v@ns            
benieuwt            	b@niyuwt             
benje               	b@nj@               
bennen              	b@n@n               
benoemt             	b@numt              
benouwen            	b@nAuw@n            
bent                	b@nt                
beplyten            	b@plit@n            
bepraeten           	b@pra:t@n           
berg                	b@rx                 
bergen              	b@rx@n               
berger              	b@rx@r                
bescheid            	b@sxEit             
bescheiden          	b@sxEid@n           
beschermheeren      	b@sx@rmh@r@n        
bescherminge        	b@sx@rmIN@          
beschryven          	b@sxriv@n           
beslaagen           	b@sla:x@n           
beslabben           	b@slAb@n            
beslikte            	b@slIkt@            
beslissen           	b@slIs@n            
besluit             	b@sl9yt             
besse               	b@s@                
best                	b@st                
bestaen             	b@sta:n             
beste               	b@st@               
besteeden           	b@st@d@n            
bestevaar           	b@st@va:r           
bestormen           	b@stOrm@n          
besukte             	b@sYkt@             
betaalen            	b@ta:l@n            
betaaling           	b@ta:lIN            
betaelen            	b@ta:l@n            
beticht             	b@tIxt              
betiên             	b@tin               
beuken              	b2:k@n               
beur                	b2:r                 
beurs               	b2:rs                
beursesnijen        	b2:rs@sni@n          
beurt               	b2:rt                
beuzelen            	b2:z@l@n             
bevat               	b@vAt               
beveelje            	b@v@lj@             
bevonden            	b@vOnd@n            
bevoorens           	b@vo:r@ns           
bevrijen            	b@vri@n             
bewaart             	b@wa:rt             
bewerken            	b@w@rk@n             
bewoogen            	b@wo:x@n            
bewys               	b@wis               
bewysen             	b@wis@n             
bewyzen             	b@wiz@n             
bezaadigd           	b@za:dIxt           
bezint              	b@zInt              
bezoeken            	b@zuk@n             
bezonder            	b@zOnd@r             
bezwaard            	b@zwa:rt            
bezwaeren           	b@zwa:r@n           
bibliotheecq        	bIblio:t@k         
bichten             	bIxt@n              
bid                 	bIt                 
bidje               	bIdj@               
bier                	bir                 
billen              	bIl@n               
billyk              	bIlik               
binje               	bInj@               
binnen              	bIn@n               
bits                	bIts                
blaauw              	blAuw               
blaân              	bla:n               
blad                	blAt                
blauwe              	blAuw@              
bleef               	bl@f                
bleek               	bl@k                
blind               	blInt               
blinden             	blInd@n             
bloed               	blut                
bloeijen            	blui@n              
bloemen             	blum@n              
bloemfestoen        	blumf@stun          
bloempje            	blumpj@             
bloempjes           	blumpj@s            
bloesem             	blus@m              
blom                	blOm                
bloodshoofds        	blo:dsho:fds        
bloosje             	blo:sj@             
bly                 	bli                 
blyf                	blif                
blyft               	blift               
blyk                	blik                
blyken              	blik@n              
blykt               	blikt               
blyspeelen          	blisp@l@n           
blyspel             	blisp@l             
blyspellen          	blisp@l@n           
blyven              	bliv@n              
blyvende            	bliv@nd@            
blyyen              	bli@n               
boek                	buk                 
boekje              	bukj@               
boel                	bul                 
boenen              	bun@n               
boer                	bur                 
boere               	bur@                
boeren              	bur@n               
boerin              	burIn               
boertjes            	burtj@s             
boete               	but@                
boeten              	but@n               
boevenstukken       	buv@nstYkk@n        
boksen              	bOks@n              
bolle               	bOl@                
bondel              	bOnd@l              
bondig              	bOndIg              
bondige             	bOndIg@             
bonk                	bOnk                
boode               	bo:d@               
boomen              	bo:m@n              
booter              	bo:t@               
bord                	bOrt               
borst               	bOrst              
bouwen              	bAuw@n              
boven               	bo:v@n               
bovengemelde        	bo:v@nx@m@ld@          
bovenste            	bo:v@nst@            
braaf               	bra:f               
braajen             	bra:i@n             
braef               	bra:f               
brande              	brAnd@              
breed               	br@t                
breede              	br@d@               
breek               	br@k                
breeken             	br@k@n              
breekspul           	br@kspYl            
breekt              	br@kt               
brengen             	br@N@n               
brengt              	br@t                
breuk               	br@k                
briefjes            	brifj@s             
brieven             	briv@n              
brocht              	brOxt               
broek               	bruk                
brokken             	brOkk@n             
brood               	bro:t               
brugman             	brYxmAn             
bruid               	br9yt               
bruigom             	br9yxOm             
bruijen             	br9y@n             
bruiloft            	br9ylOft            
bruiloften          	br9ylOft@n          
bruiloftsfeest      	br9ylOftsf@st       
bruy                	br9y                
buigen              	b9yx@n              
buiksloot           	b9ykslo:t           
buiten              	b9yt@n              
bukken              	bYkk@n              
bullepees           	bYl@p@s             
bundel              	bYnd@l              
bunschoten          	bYnsxOt@n           
burgemiesters       	bYrx@mist@rs        
burger              	bYrx@r              
buur                	byr               
buuren              	byr@n              
buurman             	byrmAn             
by                  	bi                  
byget               	bix@t               
byltje              	biltj@              
bysonder            	bisOnd@r             
bysondere           	bisOnd@r@            
byster              	bist@r               
byten               	bit@n               
bytje               	bitj@               
byzondere           	bizOnd@r@            
byzonderlyk         	bizOnd@rlIk          
byzyn               	bizin               
cabas               	ka:bAs                
calangie            	ka:lANi               
carel               	ka:r@l                
carels              	ka:r@ls               
cas                 	kAs                  
casus               	ka:sYs                
cat                 	kAt                  
catje               	kAtj@                
cees                	k@s                 
centrom             	k@ntrOm             
cesserende          	s@s@r@nd@            
claar               	kla:r               
claartje            	kla:rtj@            
cobus               	ko:bYs               
coert               	kurt                
collationeeren      	kOlAtio:n@r@n       
commediant          	kOm@diAnt          
communi             	kOmyni              
comparatie          	kOmpA:ra:ti          
compleet            	kOmpl@t             
concludeer          	kOnklyd@r           
conclusy            	kOnklysi            
condemneeren        	kOnd@mn@r@n         
confrater           	kOnfra:t@r            
confrere            	kOnfr@r@             
conjungeeren        	kOnjYnx@r@n          
consente            	kOns@nt@            
consenteren         	kOns@nt@r@n          
continuatie         	kOntInya:ti         
contra              	kOntra:             
contrarie           	kOntra:ri           
contrary            	kOntra:ri           
converseerde        	kOnv@rs@rd@          
cootjes             	ko:tj@s             
copye               	ko:pi                
coridon             	ko:ridOn            
couplet             	kupl@t             
credit              	kr@dIt              
crelis              	kr@lIs              
cyteeren            	sit@r@n              
daad                	da:t                
daag                	da:x                
daanschouwers       	da:nsxAuw@rs        
daar                	da:r                
daarom              	da:rOm              
dadvocaat           	dAdvo:ka:t            
daer                	da:r                
daerde              	da:rd@              
daerom              	da:rOm              
daet                	da:t                
dag                 	dAx                 
dagen               	da:x@n               
dak                 	dAk                 
damon               	da:mOn               
dan                 	dAn                 
dander              	dAnd@r               
dandere             	dAnd@r@              
dank                	dAnk                
dankje              	dAnkj@              
darde               	dArd@              
darme               	dArm@              
darrem              	dArr@m             
dartele             	dArt@l@            
das                 	dAs                 
dat                 	dAt                 
datj                	dAtj                
datje               	dAtj@               
datmen              	dAtm@n              
dato                	da:to:               
dats                	dAts                
dattestanten        	dAt@stAnt@n         
datze               	dAtz@               
dauws               	dAuws               
davecaet            	dAv@ka:t             
davocaaten          	dAvOkAt@n           
de                  	d@                  
dee                 	d@                  
deed                	d@t                 
deeden              	d@d@n               
deel                	d@l                 
deele               	d@l@                
deen                	d@n                 
deene               	d@n@                
deer                	d@r                 
deerste             	d@rst@              
dees                	d@s                 
deeze               	d@z@                
deezen              	d@z@n               
deezer              	d@z@                
deezes              	d@z@s               
defloratie          	d@flo:rAti          
defloravit          	d@flo:ra:vIt         
deisch              	dEis                 
deischer            	dEis@r              
demonstreeren       	d@mOnstr@r@n        
den                 	d@n                 
dende               	d@nd@               
denegatie           	d@n@xa:ti            
denk                	d@nk                
denken              	d@nk@n              
denkt               	d@nkt               
der                 	d@r                  
derde               	d@rd@                
des                 	d@s                 
dese                	d@s@                
deselve             	d@s@lv@             
desen               	d@s@n               
deugd               	d2:xt                
deugden             	d2:xd@n              
deugdzaem           	d2:xdza:m            
deun                	d2:n                 
deur                	d2:r                 
deurtrapt           	d2:rtrApt            
dewyl               	d@wil               
deze                	d@z@                
dezelve             	d@z@lv@             
dezen               	d@z@n               
dezer               	d@z@r                
dezes               	d@z@s               
dicam               	dikam                
dicht               	dIxt                
dichte              	dIxt@               
dicteeren           	dIkt@r@n            
didrik              	didrIk              
die                 	di                  
diefje              	difj@               
diek                	dik                 
dien                	din                 
dienaar             	dina:r              
dienen              	din@n               
dienst              	dinst               
dienstbereiden      	dinstb@rEid@n         
dienste             	dinst@              
dient               	dint                
diepe               	dip@                
dieper              	dip@r                
diergelyk           	dirx@lIk            
dies                	dis                 
dik                 	dIk                 
dikketons           	dIkk@tOns           
dikmaals            	dIkma:ls            
dilay               	dIlAi               
diminueeren         	diminy@r@n           
ding                	dIN                 
dingen              	dIN@n               
dirk                	dIrk               
discoerzen          	dIskurz@n           
discoreeren         	dIskOr@r@n         
discurreeren        	dIskyr@r@n           
distinctelyk        	dIstInkt@lIk        
itto                	Ito:                
doch                	dOx                 
docht               	dOxt                
dochter             	dOxt@r               
dochters            	dOxt@rs              
doctoor             	dOkto:r             
doe                 	du                  
doeje               	duj@                
doek                	duk                 
doeken              	duk@n               
doelen              	dul@n               
doen                	dun                 
doende              	dund@               
doenmaals           	dunma:ls            
doet                	dut                 
dog                 	dOx                 
dol                 	dOl                 
donker              	dOnk@r               
donnosle            	dOno:sl@             
dood                	do:t                
doodelyk            	do:d@lIk            
doof                	do:f                
doogen              	do:x@n              
doolen              	do:l@n              
doop                	do:p                
door                	do:r                
dooren              	do:r@n              
doorgronden         	do:rxrOnd@n         
doorleezen          	do:rl@z@n           
dooven              	do:v@n              
dorp                	dOrp               
douwe               	dAuw@               
douwen              	dAuw@n              
draad               	dra:t               
draag               	dra:x               
draajen             	dra:i@n             
draaven             	dra:v@n             
draed               	dra:t               
draegen             	dra:x@n             
draelen             	dra:l@n             
drasbroek           	drAsbruk            
dreigt              	drEixt               
drek                	dr@k                
drie                	dri                 
drift               	drIft               
driften             	drIft@n             
drilhuis            	drIlh9ys            
drillen             	drIl@n              
dringende           	drIN@nd@            
drink               	drInk               
drinken             	drInk@n             
droefheid           	drufhEit             
droes               	drus                
droeve              	druv@               
drogen              	drOx@n              
drok                	drOk                
drommel             	drOm@l              
droog               	dro:x               
drooge              	dro:x@              
droogen             	dro:x@n             
drooger             	dro:x@r              
drooghals           	dro:ghAls            
droomde             	dro:md@             
droomen             	dro:m@n             
dropje              	drOpj@              
drucken             	drYk@n              
druilen             	dr9yl@n             
druipen             	dr9yp@n             
drukken             	drYkk@n             
drygt               	drixt               
dubbeld             	dYb@lt              
ducatons            	dykatOns             
duigen              	d9yx@n              
duiker              	d9yk@r               
duim                	d9ym                
duitspraak          	d9ytspra:k          
dun                 	dYn                 
dunkt               	dYnkt               
dupliceerende       	duplIs@r@nd@        
duplycq             	dYplik             
durf                	dYrf               
durven              	dYrv@n             
dus                 	dYs                 
dwang               	dwAN                
dwars               	dwArs              
dwingen             	dwIN@n              
dwong               	dwON                
dyk                 	dik                 
echt                	@xt                  
echter              	@xt@r                 
eclipseert          	@klIps@rt           
edelman             	@d@lmAn             
ee                  	@                   
eed                 	@t                  
een                 	@n                  
eenen               	@n@n                
eener               	@n@r                 
eenig               	@nIg                
eenige              	@nIg@               
eenigste            	@nIxst@             
eenlyk              	@nlIk               
eenmaal             	@nma:l              
eenmael             	@nma:l              
eenpaarig           	@npa:rIg            
eens                	@ns                 
eensdeels           	@nsd@ls             
eer                 	@r                  
eerbied             	@rbit               
eerder              	@rd@r                
eeren               	@r@n                
eerlyk              	@rlIk               
eerst               	@rst                
eerste              	@rst@               
eersten             	@rst@n              
eertj               	@rtj                
eertje              	@rtj@               
eerws               	@rws                
eeten               	@t@n                
eeven               	@v@n                
effect              	@f@kt               
ehad                	@hAt                
ei                  	Ei                   
eigen               	Eix@n                
einde               	Eind@                
eindelyk            	Eind@lIk             
eindigt             	EindIxt              
eisch               	Eis                  
eischer             	Eisx@r               
eitje               	Eitj@                
ekreegen            	@kr@x@n             
el                  	@l                  
elders              	@ld@rs               
eleegen             	@l@x@n              
elk                 	@lk                 
elkaer              	@lka:r              
eloogen             	@lo:x@n             
elselaantje         	@ls@la:ntj@         
elsje               	@lsj@               
elucidatie          	@lysida:ti            
eluijert            	@l9y@rt             
em                  	@m                  
emalt               	@mAlt               
en                  	@n                  
encarel             	@nka:r@l              
encourageeren       	@nkurAZ@r@n        
end                 	@nt                 
ende                	@nd@                
enfo                	@nfo:               
engelgraaff         	@N@lxra:f            
enkele              	@nk@l@              
entwintig           	@ntwIntIg           
er                  	@r                  
erfg                	@rfx                 
etcaetera           	@ts@t@ra:            
etsi                	@tsi                
even                	@v@n                
eveneens            	@v@n@ns             
ewent               	@w@nt               
excelent            	@ks@l@nt             
exceptie            	@ks@pti              
exemplaer           	@ks@mpla:r            
exemplaren          	@ks@mplA*r@n          
exhibeeren          	@kshib@r@n            
expensis            	@ksp@nsIs             
expiratie           	@kspira:ti            
expireren           	@kspir@r@n            
expres              	@kspr@s               
expresselijk        	@kspr@s@lIk           
extensie            	@kst@nsi              
ey                  	Ei                   
eygenaars           	Eix@na:rs            
eynde               	Eind@                
ezeid               	@z@t                
faam                	fa:m                
fatsoen             	fAtsun              
february            	f@brya:ri           
feeks               	f@ks                
feilen              	f@l@n               
feit                	f@t                 
felten              	f@lt@n              
fiat                	fiAt               
figmenten           	fIxm@nt@n           
flap                	flAp                
fleemend            	fl@m@nt             
fleemende           	fl@m@nd@            
flippus             	flIppYs             
floor               	flo:r               
floortjen           	flo:rtj@n           
floreen             	flo:r@n             
fluks               	flYks               
fobert              	fOb@rt               
foberts             	fOb@rts              
foei                	fui                 
fondament           	fOnda:m@nt           
foob                	fo:p                
forma               	fOrma:             
formeel             	fOrm@l             
fout                	fAut                
fraay               	fra:i               
freek               	fr@k                
frivol              	frivOl              
fulpe               	fYlp@               
fuyke               	f9yk@               
fymelaar            	fim@la:r            
fymelaêr           	fim@la:r            
fyndoek             	finduk              
fynnen              	fin@n               
fynste              	finst@              
ga                  	xa:                 
gaa                 	xa:                 
gaan                	xa:n                
gaande              	xa:nd@              
gaat                	xa:t                
gae                 	xa:                 
gaen                	xa:n                
gaer                	xa:r                
gaet                	xa:t                
gaf                 	xAf                 
gal                 	xAl                 
gang                	xAN                 
gans                	xAns                
gantsch             	xAnts               
gast                	xAst                
gat                 	xAt                 
gatje               	xAtj@               
gauw                	xAuw                
geabbrevieerde      	x@Abr@vi@rd@          
geaccordeert        	x@AkOrd@rt          
geannulleert        	x@AnYl@rt            
gebaarden           	x@ba:rd@n           
gebeden             	x@b@d@n             
gebeên             	x@b@n               
gebeuren            	x@b2:r@n             
gebleeken           	x@bl@k@n            
gebleeven           	x@bl@v@n            
gebonden            	x@bOnd@n            
geboomte            	x@bo:mt@            
geboortestad        	x@bo:rt@stAt        
gebraaden           	x@bra:d@n           
gebracht            	x@brAxt             
gebrek              	x@br@k              
gebril              	x@brIl              
gebroed             	x@brut              
gebruycken          	x@br9yk@n           
geconditioneert     	x@kOnditio:n@rt     
geconsenteert       	x@kOns@nt@rt        
gecontraheerde      	x@kOntra:h@rd@       
gedaagde            	x@da:xd@            
gedaagden           	x@da:xd@n           
gedaagdes           	x@da:xd@s           
gedaan              	x@da:n              
gedacht             	x@dAxt              
gedachten           	x@dAxt@n            
gedaen              	x@da:n              
gedeelte            	x@d@lt@             
gedogen             	x@dOx@n             
gedooken            	x@do:k@n            
gedreeven           	x@dr@v@n            
gedroopen           	x@dro:p@n           
gedruckt            	x@drYkt             
gedruilt            	x@dr9ylt            
gedrukt             	x@drYkt             
geduld              	x@dYlt              
geduldig            	x@dYldIg            
gedulds             	x@dYlds             
gedurende           	x@dyr@nd@          
geduurende          	x@dyr@nd@          
geef                	x@f                 
geeft               	x@ft                
geen                	x@n                 
geerne              	x@rn@               
geest               	x@st                
geestig             	x@stIg              
geeven              	x@v@n               
geexamineert        	x@@ksa:min@rt         
geflonker           	x@flOnk@r            
gegaan              	x@xa:n              
gegeeven            	x@x@v@n             
gehad               	x@hAt               
geheel              	x@h@l               
geheelt             	x@h@lt              
geheeten            	x@h@t@n             
gehouden            	x@hAud@n            
gehouwen            	x@hAuw@n            
gejouisseert        	x@Zuis@rt           
gejuig              	x@j9yx               
gek                 	x@k                 
gekeelt             	x@k@lt              
gekkekooy           	x@k@ko:i           
gekleed             	x@kl@t              
gekoomen            	x@ko:m@n            
gelaat              	x@la:t              
gelag               	x@lAx               
geld                	x@lt                
geleden             	x@l@d@n             
geleeden            	x@l@d@n             
geleerd             	x@l@rt              
geleerdheid         	x@l@rdhEit           
geleezen            	x@l@z@n             
geleên             	x@l@n               
gelegt              	x@l@xt              
gelen               	x@l@n               
gelet               	x@l@t               
geliefden           	x@lifd@n            
gelieven            	x@liv@n             
geloofbaare         	x@lo:fba:r@         
geloogen            	x@lo:x@n            
geloopen            	x@lo:p@n            
gelooven            	x@lo:v@n            
gelubde             	x@lYbd@             
gelyk               	x@lik               
gelyken             	x@lik@n             
gelykenis           	x@lik@nIs           
gelykenissen        	x@lik@nIs@n         
gemaakt             	x@ma:kt             
gemaklyk            	x@mAklIk            
gemeen              	x@m@n               
gemoed              	x@mut               
gemoet              	x@mut               
genaamd             	x@na:mt             
genaamt             	x@na:mt             
genegen             	x@n@x@n             
genieten            	x@nit@n             
genigen             	x@nIx@n             
genoeg              	x@nux               
genood              	x@no:t              
genoomen            	x@no:m@n            
genootsaakt         	x@no:tsa:kt         
geoctroyeert        	x@Oktro:i@@rt         
gepaerd             	x@pa:rt             
gepeinzen           	x@pEinz@n            
gepermitteert       	x@p@rmIt@rt          
geplaatst           	x@pla:tst           
gepleeten           	x@pl@t@n            
gepleit             	x@plEit              
geprocreert         	x@prOkr@@rt          
geproduceerd        	x@pro:dys@rt         
gepromoveert        	x@pro:mo:v@rt         
gepruilt            	x@pr9ylt            
gepurgeert          	x@pYrx@rt          
geraaden            	x@ra:d@n             
geraaken            	x@ra:k@n             
geraas              	x@ra:s               
geraekt             	x@ra:kt              
gerard              	x@rArt              
gerecht             	x@r@xt                
gerechtskaamer      	x@r@xtska:m@r          
gereed              	x@r@t                
gereeden            	x@r@d@n              
gereegen            	x@r@x@n              
gerequireerdens     	x@r@kwir@rd@ns      
gerippereert        	x@rIpp@r@rt           
gerust              	x@rYst               
gescheurt           	x@sx2:rt           
geschieden          	x@sxid@n            
geschiet            	x@sxit              
geschiên           	x@sxin              
geschut             	x@sxYt              
geselschap          	x@s@lsxAp           
geslacht            	x@slAxt             
geslagt             	x@slAxt             
gesloopen           	x@slo:p@n           
gesnap              	x@snAp              
gesoen              	x@sun               
gesol               	x@sOl               
gespannen           	x@spAn@n            
gesprek             	x@spr@k             
gesprooten          	x@spro:t@n          
gestaan             	x@sta:n             
gesteld             	x@st@lt             
gestoffeert         	x@stOf@rt           
gestommel           	x@stOm@l            
gestooken           	x@sto:k@n           
gestoolen           	x@sto:l@n           
gestooven           	x@sto:v@n           
gestort             	x@stOrt            
gestreeken          	x@str@k@n           
gesubcenteert       	x@sYbs@nt@rt        
get                 	x@t                 
getalm              	x@tAlm              
getreeden           	x@tr@d@n            
getrouwd            	x@trAuwt            
getuigen            	x@t9yx@n            
getuignis           	x@t9yxnIs           
geurig              	x2:rIg               
geurige             	x2:rIg@              
geval               	x@vAl               
geven               	x@v@n               
gevoerd             	x@vurt              
gevoert             	x@vurt              
gevolg              	x@vOlx              
gevolgt             	x@vOlxt             
gevonden            	x@vOnd@n            
geween              	x@w@n               
geweest             	x@w@st              
geweeten            	x@w@t@n             
geweld              	x@w@lt              
gewis               	x@wIs               
gewonnen            	x@wOn@n             
gezegt              	x@z@xt              
gezeid              	x@zEit               
gezelschap          	x@z@lsxAp           
gezet               	x@z@t               
gezicht             	x@zIxt              
gezien              	x@zin               
gien                	xin                 
ging                	xIN                 
gissen              	xIs@n               
gistren             	xIstr@n             
glas                	xlAs                
godshuisen          	xOdsh9ys@n          
godshuysen          	xOdsh9ys@n          
goe                 	xu                  
goed                	xut                 
goede               	xud@                
goedwilligheid      	xudwIlIghEit          
goeje               	xuj@                
gong                	xON                 
gooit               	xo:it               
goosens             	xo:s@ns             
graag               	xra:x               
gracy               	xrAs                
graeg               	xra:x               
gratie              	xra:ti               
gratificeren        	xra:tIfIs@r@n         
grauwt              	xrAuwt              
greep               	xr@p                
grillen             	xrIl@n              
grimlacht           	xrImlAxt            
grimmeld            	xrIm@lt             
groen               	xrun                
grof                	xrOf                
grond               	xrOnt               
gronden             	xrOnd@n             
grondig             	xrOndIg             
groot               	xro:t               
groote              	xro:t@              
grootjes            	xro:tj@s            
grootte             	xro:t@              
grote               	xrOt@               
grouwen             	xrAuw@n             
grypen              	xrip@n              
grypt               	xript               
guil                	x9yl                
guilen              	x9yl@n              
guldens             	xYld@ns             
gun                 	xYn                 
gunst               	xYnst               
gunter              	xYnt@r               
gy                  	xi                  
haalt               	ha:lt               
haamer              	ha:m@r               
haamertje           	ha:m@rtj@            
haamlebout          	ha:ml@bAut          
haan                	ha:n                
haantje             	ha:ntj@             
haar                	ha:r                
haard               	ha:rt               
haare               	ha:r@               
haarig              	ha:rIg              
haast               	ha:st               
haazepad            	ha:z@pAt            
had                 	hAt                 
hadden              	hAd@n               
hady                	ha:di                
haelen              	ha:l@n              
haer                	ha:r                
haeren              	ha:r@n              
haest               	ha:st               
haestig             	ha:stIg             
hage                	ha:x@                
half                	hAlf                
hallef              	hAl@f               
hals                	hAls                
hamer               	ha:m@                
hand                	hAnt                
handen              	hAnd@n              
hangen              	hAN@n               
hanggat             	hANxAt              
hangoor             	hANo:r              
hans                	hAns                
hapt                	hApt                
hard                	hArt               
harde               	hArd@              
harder              	hArd@r              
harderwyk           	hArd@rwik           
hare                	ha:r@               
haren               	ha:r@n              
harssendroomen      	hArs@ndro:m@n      
harssens            	hArs@ns            
hart                	hArt               
hartelyk            	hArt@lIk           
harten              	hArt@n             
hartseer            	hArts@r            
he                  	h@                  
heb                 	h@p                 
hebbe               	h@b@                
hebben              	h@b@n               
hebbende            	h@b@nd@             
hebj                	h@bj                
hebje               	h@bj@               
heblykheid          	h@blIkhEit           
hebt                	h@pt                
hebze               	h@bz@               
heeft               	h@ft                
heel                	h@l                 
heele               	h@l@                
heelen              	h@l@n               
heemel              	h@m@l               
heen                	h@n                 
heenen              	h@n@n               
heer                	h@r                 
heeren              	h@r@n               
heerschip           	h@rsxIp             
heggen              	h@x@n               
heid                	hEit                 
heinsius            	hEinsiYs             
hek                 	h@k                 
helaas              	h@la:s              
help                	h@lp                
helpen              	h@lp@n              
helpje              	h@lpj@              
helpt               	h@lpt               
hem                 	h@m                 
hen                 	h@n                 
hendrik             	h@ndrIk             
henglen             	h@Nl@n               
herberg             	h@rb@rx               
herhaalen           	h@rha:l@n            
hervormen           	h@rvOrm@n           
het                 	h@t                 
heunig              	h2:nIg               
heur                	h2:r                 
heurs               	h2:rs                
hiel                	hil                 
hiele               	hil@                
hier                	hir                 
hikkende            	hIkk@nd@            
ho                  	ho:                 
hoe                 	hu                  
hoed                	hut                 
hoedraakt           	hudra:kt            
hoeft               	huft                
hoer                	hur                 
hoertje             	hurtj@              
hoesen              	hus@n               
hoewel              	huw@l               
hof                 	hOf                 
hoge                	ho:x@                
hola                	ho:la:               
holland             	hOlAnt              
homeris             	ho:m@rIs              
hond                	hOnt                
honderd             	hOnd@rt              
hondert             	hOnd@rt              
honig               	ho:nIg               
hoofd               	ho:ft               
hooft               	ho:ft               
hoog                	ho:x                
hoogen              	ho:x@n              
hoogsten            	ho:xst@n            
hoopen              	ho:p@n              
hoor                	ho:r                
hooren              	ho:r@n              
hoort               	ho:rt               
hooy                	ho:i                
hop                 	hOp                 
hou                 	hAu                 
houd                	hAut                
houden              	hAud@n              
houdende            	hAud@nd@            
houtskool           	hAutsko:l           
houwen              	hAuw@n              
huer                	hyr                 
huibert             	h9yb@rt              
huilebalk           	h9yl@bAlk           
huilen              	h9yl@n              
huilende            	h9yl@nd@            
huilt               	h9ylt               
huis                	h9ys                
huizen              	h9yz@n              
hulp                	hYlp                
hun                 	hYn                 
hunne               	hYn@                
huuwelyk            	hyw@lIk            
huuwlyk             	hyw@lik             
huuwlyks            	hyw@lIks            
huuwlykszaaken      	hyw@lIksza:k@n      
hy                  	hi                  
hyntje              	hintj@              
hyze                	hiz@                
ibi                 	Ibi                 
iemand              	imAnt               
ien                 	in                  
iens                	ins                 
iets                	its                 
ik                  	Ik                  
immensis            	Im@nsIs             
immermeer           	Im@rm@r              
immers              	Im@rs                
impartinency        	ImpArtin@nsi        
impartinent         	ImpArtin@nt        
impregnavit         	Impr@xnAvIt         
in                  	In                  
inbeelden           	Inb@ld@n            
influeren           	Inflyr@n            
ingebragte          	Inx@brAxt@           
ingeleid            	Inx@lEit              
inhoude             	InhAud@             
injungeeren         	InjYN@r@n           
inktkooker          	Inktko:k@r           
inne                	In@                 
insonderheid        	InsOnd@h@t          
interpoosen         	Int@po:s@n          
intreên            	Intr@n              
inwendige           	Inw@ndIg@           
irrelevant          	Ir@l@vAnt         
irreprochabel       	Ir@prOxAb@l       
is                  	Is                  
ja                  	ja:                 
jaagen              	ja:x@n              
jaap                	ja:p                
jaapje              	ja:pj@              
jaar                	ja:r                
jaaren              	ja:r@n              
jaars               	ja:rs               
jacht               	jAxt                
jachtig             	jAxtIg              
jacob               	ja:kOp               
jacobus             	ja:kObYs             
jaegt               	ja:xt               
jaep                	ja:p                
jaer                	ja:r                
jaeren              	ja:r@n              
jan                 	jAn                 
janken              	jAnk@n              
janne               	jAn@                
jannetje            	jAn@tj@             
jansz               	jAns               
jaren               	ja:r@n              
je                  	j@                  
jegens              	j@x@ns              
jem                 	j@m                 
jemy                	j@mi                
jer                 	j@r                  
jeremias            	j@r@miAs            
jesse               	j@s@                
jet                 	j@t                 
jeugd               	j2:xt                
jeugdig             	j2:xdIg              
joachimus           	joAximYs            
joan                	jo:An              
joannes             	jo:An@s              
jochem              	jOx@m               
jongen              	jON@n               
jongmans            	jONmAns             
jongspel            	jONsp@l             
jongspul            	jONspYl             
jonker              	jOnk@r               
jons                	jOns                
joppen              	jOpp@n              
jorden              	jOrd@n             
joris               	jOrIs              
jou                 	jAu                 
joului              	jAul9y              
jouwen              	jAuw@n              
jouwent             	jAuw@nt             
juffrouw            	jYfrAuw             
juist               	j9yst               
jy                  	ji                  
kaamer              	ka:m@r               
kaameraet           	ka:m@ra:t            
kaamerdeur          	ka:m@rd2:r            
kaarsen             	ka:rs@n             
kaart               	ka:rt               
kaele               	ka:l@               
kaeter              	ka:t@r               
kal                 	kAl                 
kalf                	kAlf                
kamer               	ka:m@r                
kan                 	kAn                 
kanjuweeltje        	kAnjyw@ltj@        
kans                	kAns                
kansje              	kAnsj@              
kant                	kAnt                
kap                 	kAp                 
karel               	ka:r@l              
karsten             	kArst@n            
keel                	k@l                 
keeren              	k@r@n               
keert               	k@rt                
kees                	k@s                 
keijers             	k@j@rs               
keirel              	kEir@l               
ken                 	k@n                 
kenje               	k@nj@               
kennis              	k@nIs               
kent                	k@nt                
keunings            	k2:nINs              
keuninklyk          	k2:nInklIk           
keunje              	k2:nj@               
kies                	kis                 
kikvorschen         	kIkvOrs@n         
kind                	kInt                
kinders             	kInd@rs              
kindsgebeenten      	kIndsx@b@nt@n       
kinkel              	kInk@l              
kinkels             	kInk@ls             
klaar               	kla:r               
klaare              	kla:r@              
klaarheid           	kla:rhEit            
klaarleid           	kla:rlEit            
klaartje            	kla:rtj@            
klacht              	klAxt               
klachten            	klAxt@n             
klad                	klAt                
kladde              	klAd@               
klaer               	kla:r               
klaeren             	kla:r@n             
klappen             	klApp@n             
kleeren             	kl@r@n              
kleêren            	kl@r@n              
klein               	klEin                
klerk               	kl@k                
kleutergeld         	kl2:t@rx@lt           
klompen             	klOmp@n             
klop                	klOp                
kloppen             	klOpp@n             
kloppende           	klOpp@nd@           
klopt               	klOpt               
klouwen             	klAuw@n             
kluchten            	klYxt@n             
kluchtspel          	klYxtsp@l           
kluiten             	kl9yt@n             
knaphandig          	knAphAndIg          
kneep               	kn@p                
kneepen             	kn@p@n              
kneppels            	kn@pp@ls            
kneukels            	kn2:k@ls             
knie                	kni                 
knier               	knir                
kniertje            	knirtj@             
knikkebeen          	knIkk@b@n           
knikkende           	knIkk@nd@           
knikkerbil          	knIkk@rbIl           
knikt               	knIkt               
knoesten            	knust@n             
knol                	knOl                
knollen             	knOl@n              
knolles             	knOl@s              
knoppen             	knOpp@n             
knorrepot           	knOrr@pOt          
koek                	kuk                 
koeken              	kuk@n               
kom                 	kOm                 
komen               	ko:m@n               
komje               	ko:mj@               
kommer              	kOm@                
komt                	kOmt                
kon                 	kOn                 
koningen            	kOnIN@n             
kool                	ko:l                
koomen              	ko:m@n              
koop                	ko:p                
koos                	ko:s                
koot                	ko:t                
kop                 	kOp                 
koppelaar           	kOpp@la:r           
kort                	kOrt               
kortswylige         	kOrtswilIg@        
kosten              	kOst@n              
koud                	kAut                
kraag               	kra:x               
kraajen             	kra:i@n             
kraam               	kra:m               
kraamer             	kra:m@r              
kraamtyd            	kra:mtit            
krabben             	krAb@n              
kracht              	krAxt               
krachten            	krAxt@n             
kraeken             	kra:k@n             
kreeg               	kr@x                
kreek               	kr@k                
krenken             	kr@nk@n             
krenten             	kr@nt@n             
krieken             	krik@n              
krielen             	kril@n              
krioelen            	kriul@n           
kruipen             	kr9yp@n             
kruis               	kr9ys               
krukken             	krYkk@n             
krygen              	krix@n              
krygende            	krix@nd@            
krygt               	krixt               
kryn                	krin                
krynen              	krin@n              
kryns               	krins               
krynvaar            	krinva:r            
kunnen              	kYn@n               
kunst               	kYnst               
kunt                	kYnt                
kusje               	kYsj@               
kusjes              	kYsj@s              
kusschen            	kYs@n              
kwaad               	kwa:t               
kwaaker             	kwa:k@r              
kwae                	kwa:                
kwalyk              	kwa:lIk              
kwam                	kwAm                
kwast               	kwAst               
kwellen             	kw@l@n              
kwyl                	kwil                
kwyt                	kwit                
kyk                 	kik                 
kyken               	kik@n               
kykt                	kikt                
kykuit              	kik9yt              
kynd                	kInt                
kyven               	kiv@n               
laan                	la:n                
laat                	la:t                
laaten              	la:t@n              
laater              	la:t@               
laatste             	la:tst@             
laazen              	la:z@n              
lachen              	lAx@n               
laelyk              	la:lIk              
laen                	la:n                
laet                	la:t                
laeten              	la:t@n              
lag                 	lAx                 
lam                 	lAm                 
land                	lAnt                
lande               	lAnd@               
landen              	lAnd@n              
lang                	lAN                 
lange               	lAN@                
langer              	lAN@r                
langs               	lANs                
langzaam            	lANza:m             
lap                 	lAp                 
lapje               	lApj@               
las                 	lAs                 
laste               	lAst@               
lasten              	lAst@n              
lasteraar           	lAst@ra:r            
latona              	la:to:na:             
lavement            	la:v@m@nt            
ledig               	l@dIg               
leed                	l@t                 
leeger              	l@x@r                
leek                	l@k                 
leelyk              	l@lIk               
leen                	l@n                 
leendert            	l@nd@rt              
leeren              	l@r@n               
leert               	l@rt                
leest               	l@st                
leeven              	l@v@n               
leevens             	l@v@ns              
leever              	l@v@r                
leezen              	l@z@n               
leg                 	l@x                 
leggen              	l@x@n               
legt                	l@xt                
lei                 	lEi                  
leid                	lEit                 
leijen              	lEi@n               
leit                	lEit                 
lenden              	l@nd@n              
leonard             	l@o:nArt             
lest                	l@st                
letten              	l@t@n               
leyden              	lEid@n               
licenciaat          	lIks@nsia:t           
licht               	lIxt                
lichte              	lIxt@               
lichten             	lIxt@n              
lichtlyk            	lIxtlIk             
lieden              	lid@n               
liedje              	lidj@               
lief                	lif                 
liefd               	lift                
liefde              	lifd@               
liefdens            	lifd@ns             
lieffelyke          	lif@lIk@            
liefkoost           	lifko:st            
liefst              	lifst               
liep                	lip                 
liet                	lit                 
lieve               	liv@                
liever              	liv@r                
liên               	lin                 
ligt                	lIxt                
lijen               	li@n                
likken              	lIkk@n              
linden              	lInd@n              
lippen              	lIpp@n              
loeren              	lur@n               
loerend             	lur@nt              
lompe               	lOmp@               
lompen              	lOmp@n              
loof                	lo:f                
loogen              	lo:x@n              
loopen              	lo:p@n              
looper              	lo:p@r               
los                 	lOs                 
lossen              	lOs@n               
louwtjens           	lAuwtj@ns           
lubben              	lYb@n               
lucht               	lYxt                
luchten             	lYxt@n              
luchtig             	lYxtIg              
luidkeels           	l9ydk@ls            
luimen              	l9ym@n              
luisenek            	l9ys@n@k            
luisenseaet         	l9ys@ns@a:t          
luister             	l9yst@r              
luistren            	l9ystr@n            
luitjes             	l9ytj@s             
lukken              	lYkk@n              
lust                	lYst                
lustig              	lYstIg              
luy                 	lYi                 
luyster             	lYIst@              
ly                  	li                  
lyd                 	lit                 
lydde               	lId@                
lyden               	lid@n               
lyf                 	lif                 
lyjen               	lij@n               
lyk                 	lik                 
lykt                	likt                
lywaat              	liwa:t              
maag                	ma:x                
maak                	ma:k                
maaken              	ma:k@n              
maakende            	ma:k@nd@            
maakje              	ma:kj@              
maakt               	ma:kt               
maal                	ma:l                
maand               	ma:nt               
maanden             	ma:nd@n             
maanlicht           	ma:nlIxt            
maar                	ma:r                
macht               	mAxt                
maek                	ma:k                
maeken              	ma:k@n              
maekt               	ma:kt               
maenen              	ma:n@n              
maer                	ma:r                
maet                	ma:t                
mag                 	mAx                 
magt                	mAxt                
mai                 	mAi                 
maken               	ma:k@n               
mal                 	mAl                 
malkaar             	mAlka:r             
malkander           	mAlkAnd@r            
malkanderen         	mAlkAnd@r@n          
malkanderens        	mAlkAnd@r@ns         
malle               	mAl@                
mallen              	mAl@n               
man                 	mAn                 
mand                	mAnt                
manden              	mAnd@n              
mannen              	mAn@n               
mannenbroek         	mAn@nbruk           
mannenhuis          	mAn@nh9ys           
mannenhuys          	mAn@nh9ys           
mans                	mAns                
manu                	mAny                
maski               	mAski               
mat                 	mAt                 
materie             	ma:t@ri               
matrimony           	ma:trimo:ni           
me                  	m@                  
mede                	m@d@                
medely              	m@d@li              
mee                 	m@                  
meed                	m@t                 
meede               	m@d@                
meedoogend          	m@do:x@nt           
meen                	m@n                 
meenen              	m@n@n               
meening             	m@nIN               
meenj               	m@nj                
meent               	m@nt                
meer                	m@r                 
meerder             	m@rd@r               
meest               	m@st                
meeste              	m@st@               
meesten             	m@st@n              
meester             	m@st@r               
meesters            	m@st@rs              
meeters             	m@t@rs               
meezen              	m@z@n               
meê                	m@                  
meêr               	m@r                 
meid                	mEit                 
meisje              	mEisj@               
meisjes             	mEisj@s              
mekaer              	m@ka:r              
melis               	m@lIs               
men                 	m@n                 
menageeren          	m@na:Z@r@n           
menig               	m@nIg               
menigmaalen         	m@nIxma:l@n         
menschen            	m@ns@n             
mensk               	m@nsk               
mentie              	m@nti               
mer                 	m@                  
merken              	m@rk@n               
met                 	m@t                 
meug                	m2:x                 
meugje              	m2:xj@               
meugt               	m2:xt                
middels             	mId@ls              
midden              	mId@n               
middlen             	mIdl@n              
mien                	min                 
mies                	mis                 
min                 	mIn                 
minder              	mInd@r               
minnelusjes         	mIn@lYsj@s          
minneviertje        	mIn@virtj@          
minst               	mInst               
minste              	mInst@              
minsten             	mInst@n             
mis                 	mIs                 
misdaan             	mIsda:n             
misdryven           	mIsdriv@n           
misduiden           	mIsd9yd@n           
misschien           	mIsxin              
missen              	mIs@n               
mits                	mIts                
mitsgaders          	mItsxa:d@rs           
mitsgarder          	mItsxa:rd@r          
mocht               	mOxt                
moe                 	mu                  
moed                	mut                 
moeilyk             	muilIk              
moeiten             	muit@n              
moer                	mur                 
moertje             	murtj@              
moest               	must                
moesten             	must@n              
moet                	mut                 
moeten              	mut@n               
moezen              	muz@n               
moêr               	mur                 
mogen               	mo:x@n               
mogten              	mo:xt@n              
mompelende          	mOmp@l@nd@          
mompelt             	mOmp@lt             
momus               	mOmYs               
mond                	mOnt                
monde               	mOnd@               
moogelyk            	mo:x@lIk            
moogen              	mo:x@n              
moogje              	mo:xj@              
mooglyk             	mo:xlIk             
mooi                	mo:i                
mooije              	mo:i@               
mooy                	mo:i                
morgen              	mOrx@n             
morgens             	mOrx@ns            
mortje              	mOrtj@             
mostert             	mOst@rt              
mouw                	mAuw                
muffen              	mYf@n               
munt                	mYnt                
murruwer            	mYrryw@r           
murw                	mYrw               
musicaale           	mysika:l@            
my                  	mi                  
myn                 	min                 
myne                	min@                
myner               	min@r                
myns                	mins                
na                  	na:                 
naaden              	na:d@n              
naajen              	na:j@n              
naakt               	na:kt               
naakte              	na:kt@              
naam                	na:m                
naar                	na:r                
naargedruckt        	na:rx@drYkt         
naargedruckte       	na:rx@drYkt@        
naast               	na:st               
nacht               	nAxt                
nadeel              	nAd@l               
nader               	nAd@                
nadrukken           	nAdrYkk@n           
nae                 	na:                 
naer                	na:r                
naêr               	na:r                
nagel               	na:x@l               
narree              	na:r@              
naspreekende        	na:spr@k@nd@         
nauw                	nAuw                
nederigheid         	n@d@rIghEit            
neel                	n@l                 
neeltje             	n@ltj@              
neemen              	n@m@n               
neemje              	n@mj@               
neemt               	n@mt                
neen                	n@n                 
neer                	n@r                 
neerduitsch         	n@rd9yts            
neet                	n@t                 
neêrgeset          	n@rx@s@t            
nemaar              	n@ma:r              
nemen               	n@m@n               
net                 	n@t                 
netjes              	n@tj@s              
neus                	n2:s                 
neusdoek            	n2:sduk              
neutekraaker        	n2:t@kra:k@          
neuten              	n2:t@n               
nevens              	n@v@ns              
niemand             	nimAnt              
niet                	nit                 
niets               	nits                
nieuwe              	niyu@               
noch                	nOx                 
noem                	num                 
noemen              	num@n               
noemt               	numt                
nog                 	nOx                 
nood                	no:t                
noodig              	no:dIg              
noodje              	no:dj@              
nooit               	no:it               
notaris             	no:ta:rIs            
nou                 	nAu                 
november            	nOv@mb@r             
nu                  	ny                  
nut                 	nYt                 
nuyts               	n9yts               
nygende             	nix@nd@             
och                 	Ox                  
octroy              	OktrOi              
octroye             	Oktro:i@            
octroyeren          	Oktro:i@r@n         
of                  	Of                  
officier            	Ofisir               
ofte                	Oft@                
olyk                	OlIk                
om                  	Om                  
omissie             	OmIsi               
omkeeren            	Omk@r@n             
omme                	Om@                 
omni                	Omni                
omtrent             	Omtr@nt             
onbehoorlyks        	Onb@ho:rlIks        
onbekrompen         	Onb@krOmp@n         
onbewust            	Onb@wYst            
onder               	Ond@r               
onderdanig          	Ond@rdAnIg           
onderschryven       	Ond@rsxriv@n         
onderst             	Ond@rst              
ondertusschen       	Ond@rtYs@n          
ondervonden         	Ond@rvOnd@n          
onderweeg           	Ond@rw@x             
onderwerp           	Ond@rw@rp             
onderwinden         	Ond@rwInd@n          
onderwyl            	Ond@wil             
onderwylen          	Ond@rwil@n           
ongderhouwen        	ONd@rhAuw@n          
ongevraagd          	ON@rvra:xt           
ongzent             	ONz@nt              
onheblyks           	Onh@blIks           
onlangs             	OnlANs              
onmoogelyk          	Onmo:x@lIk          
onmooglyk           	Onmo:xlIk           
onnoodig            	Ono:dIg             
onnoosle            	Ono:sl@             
onnopsle            	OnOpsl@             
onnut               	OnYt                
ons                 	Ons                 
onse                	Ons@                
onsen               	Ons@n               
onses               	Ons@s               
onsmaaklyk          	Onsma:klIk          
ontbreeken          	Ontbr@k@n           
ontdekken           	Ontd@kk@n           
onteeren            	Ont@r@n             
onthoud             	OnthAut              
ontkennen           	Ontk@n@n            
ontkleed            	OntklEit             
ontlooken           	Ontlo:k@n           
ontloopen           	Ontlo:p@n           
ontmoet             	Ontmut              
ontmoetende         	Ontmut@nd@          
ontroofd            	Ontro:ft            
ontrooven           	Ontro:v@n           
ontvrachten         	OntvrAxt@n          
onty                	Onti                
ontydig             	OntidIg             
ontzeggen           	Ontz@x@n            
ontzegging          	Ontz@xIN            
ontzegt             	Ontz@xt             
onwilligheid        	OnwIlIg@t           
onze                	Onz@                
onzen               	Onz@n               
oog                 	o:x                 
oogen               	o:x@n               
oogwit              	o:xwIt              
ooit                	o:it                
ook                 	o:k                 
oordeelt            	o:rd@lt             
ooren               	o:r@n               
oorsprong           	o:rsprON            
oorzaak             	o:rza:k             
oost                	o:st                
op                  	Op                  
opdragt             	OpdrAxt             
open                	Op@n                
openbaeren          	Op@nba:r@n          
opende              	Op@nd@              
opereeren           	Op@r@r@n             
opgaan              	Opxa:n              
opgepast            	Opx@pAst            
opgepropt           	Opx@prOpt           
opgeschort          	Opx@sxOrt          
opgetoogen          	Opx@to:x@n          
opgetooid           	Opx@to:it           
opmerking           	Opm@rkIN             
oprecht             	Opr@xt               
oprechtende         	Opr@xt@nd@           
opschrift           	OpsxrIft            
opslaan             	Opsla:n             
opstaande           	Opsta:nd@           
opstond             	OpstOnt             
opstonds            	OpstOnds            
ordinary            	Ordina:ri          
ordonnantie         	OrdOnAnti          
ordonneeren         	OrdOn@r@n          
oreeren             	o:r@r@n             
otten               	Ot@n                
oude                	Aud@                
ouden               	Aud@n               
ouderloose          	Aud@rlo:s@           
ouwe                	Auw@                
ouwerwetse          	Auw@rw@ts@          
over                	Ov@r                 
overboodig          	Ov@rbo:dIg           
overende            	Ov@r@nd@             
overgemerckt        	Ov@rx@m@rkt           
overlang            	Ov@rlAN              
overleggen          	Ov@rl@x@n            
overluid            	Ov@rl9yt             
overschaduwen       	Ov@rsxAdyu@n         
overslaan           	Ov@rsla:n            
overweegen          	Ov@rw@x@n            
ô                  	o:                  
paait               	pa:it               
paal                	pa:l                
paar                	pa:r                
paardje             	pa:rdj@             
paars               	pa:rs               
paciensy            	pAsi@nsi             
pacquet             	pAkk@t             
pad                 	pAt                 
paer                	pa:r                
paeren              	pa:r@n              
pak                 	pAk                 
pakje               	pAkj@               
pampieren           	pAmpir@n            
pan                 	pAn                 
papier              	pApir               
papieren            	pApir@n             
papiertjes          	pApirtj@s           
part                	pArt               
parthy              	pArti              
parthyen            	pArti@n             
parthys             	pArtis             
particulier         	pArtikylir          
party               	pArti              
partyen             	pArti@n             
pas                 	pAs                 
passe               	pAs@                
passeeren           	pAs@r@n             
peis                	pEis                 
penen               	p@n@n               
pennen              	p@n@n               
penning             	p@nIN               
periode             	p@rio:d@             
persisteeren        	p@rsIst@r@n          
peur                	p2:r                 
peurd               	p2:rt                
phlegmatiecq        	phl@xmAtik         
piek                	pik                 
pier                	pir                 
piet                	pit                 
pieter              	pit@r                
pik                 	pIk                 
pikken              	pIkk@n              
pinkster            	pInkst@r             
pislap              	pIslAp              
plaagen             	pla:x@n             
plaas               	pla:s               
plaats              	pla:ts              
plaatsen            	pla:ts@n            
plaets              	pla:ts              
plag                	plAx                
plaisier            	plAisir             
plakt               	plAkt               
plat                	plAt                
platte              	plAt@               
pleeg               	pl@x                
pleidooijeeren      	plEido:i@r@n         
pleidooijen         	plEido:i@n           
pleidooy            	plEido:i             
pleidoyeeren        	plEido:i@r@n         
pleit               	plEit                
pleiten             	plEit@n              
pleiters            	plEit@rs              
pleitrok            	plEitrOk             
pleitzak            	pleitzAk             
pluimer             	pl9ym@r              
pluist              	pl9yst              
plukken             	plYkk@n             
pluwier             	plyuir              
plyt                	plit                
plyten              	plit@n              
poelsnip            	pulsnIp             
poen                	pun                 
poene               	pun@                
poëtiecque         	po:@tik@            
pollen              	pOl@n               
ponzekoek           	pOnz@kuk            
poogt               	po:xt               
pooijen             	po:i@n              
poosen              	po:s@n              
poot                	po:t                
pooten              	po:t@n              
post                	pOst                
pot                 	pOt                 
praat               	pra:t               
praaten             	pra:t@n             
praatende           	pra:t@nd@           
praater             	pra:t@r              
prachen             	prAx@n              
praesertim          	pra:s@tIm           
praet               	pra:t               
praeten             	pra:t@n             
praetjes            	pra:tj@s            
precautioneel       	pr@kAutio:n@l        
prepareeren         	pr@pa:r@r@n         
presentacy          	pr@s@ntasi           
president           	pr@sid@nt           
presidents          	pr@sid@nts          
preutse             	pr2:ts@              
prezident           	pr@zid@nt           
primis              	primIs              
primo               	primo:              
prinsedent          	prIns@d@nt          
privilegie          	privil@Zi           
probeeren           	pro:b@r@n            
procedant           	pro:s@dAnt           
proces              	pro:s@s              
processe            	pro:s@s@             
procureurs          	pro:kyr2:rs            
produceeren         	pro:dys@r@n          
prolix              	pro:lIks             
prolongatie         	pro:lONa:ti           
pronuncieeren       	pro:nYnsi@r@n         
proppen             	prOpp@n             
prossedeeren        	prOs@d@r@n          
protextie           	prOt@kti             
pruimen             	pr9ym@n             
prulle              	prYl@               
prullen             	prYl@n              
pry                 	pri                 
prykt               	prikt               
prys                	pris                
prytje              	pritj@              
pryzen              	priz@n              
publyk              	pyblik              
puit                	p9yt                
puiterveen          	p9yt@rv@n            
puiterveenen        	p9yt@rv@n@n          
punt                	pYnt                
puur                	pyr               
qua                 	kwa:                
qualitate           	kwa:lita:t@           
qualiteit           	kwa:litEit            
qualiteyt           	kwa:litEit            
quartus             	kwArtYs            
quid                	kwIt                
raad                	ra:t                
raaken              	ra:k@n              
raakend             	ra:k@nt             
raakt               	ra:kt               
raakte              	ra:kt@              
raar                	ra:r                
rabbelende          	rAb@l@nd@           
raed                	ra:t                
raeken              	ra:k@n              
raekje              	ra:kj@              
raekt               	ra:kt               
raet                	ra:t                
raên               	ra:n                
randen              	rAnd@n              
rang                	rAN                 
rangeeren           	rAnZ@r@n             
rank                	rAnk                
ranken              	rAnk@n              
rapsody             	rApso:di             
rebel               	r@b@l               
recht               	r@xt                 
rechtbank           	r@xtbAnk             
rechtbankzaamen     	r@xtbAnkza:m@n       
rechte              	r@xt@                
rechten             	r@xt@n               
rechter             	r@xt@r                
rechters            	r@xt@rs               
rechthuis           	r@xth9ys              
rechts              	r@xts                
rechtsgeding        	r@xtsx@dIN           
rechtsgedingen      	r@xtsx@dIN@n         
rechtsgeleerden     	r@xtsx@l@rd@n        
rechtskaamer        	r@xtska:m@           
recitatief          	r@sita:tif            
ree                 	r@                  
reede               	r@d@                
reeden              	r@d@n               
reedenen            	r@d@n@n             
reeds               	r@ds                
reets               	r@ts                
reên               	r@n                 
refuseeren          	r@fys@r@n           
regenten            	r@x@nt@n            
reinigen            	rEinIx@n             
reis                	rEis                 
reparatie           	r@pa:ra:ti           
repje               	r@pj@               
repliceerende       	r@plis@r@nd@        
repliek             	r@plik              
replycq             	r@plik             
reproche            	r@prOx@             
reputatie           	r@pyta:ti            
requirant           	r@kwirAnt          
respective          	r@sp@ktiv@          
rest                	r@st                
resterende          	r@st@r@nd@           
resumeeren          	r@sym@r@n           
resumptie           	r@sYmpti            
ribben              	rIb@n               
rinkelrooijen       	rInk@lro:i@n        
rispeteeren         	rIsp@t@r@n          
roeijen             	rui@n               
roep                	rup                 
roept               	rupt                
roeren              	rur@n               
rogge               	rOx@                
rok                 	rOk                 
rolle               	rOl@                
rond                	rOnt                
ronde               	rOnd@               
rondom              	rOndOm              
rooseknopje         	ro:s@knOpj@         
roosen              	ro:s@n              
roosje              	ro:sj@              
rooven              	ro:v@n              
rouwen              	rAuw@n              
rubben              	rYb@n               
ruchtbaer           	rYxtba:r            
ruikt               	r9ykt               
ruim                	r9ym                
rust                	rYst                
rustelyk            	rYst@lIk            
ryke                	rik@                
ryksdaalders        	rIksda:ld@rs         
rylt                	rIlt                
rype                	rip@                
ryzen               	riz@n               
saacke              	sa:k@               
saam                	sa:m                
sabben              	sAb@n               
saemen              	sa:m@n              
saggelaer           	sAx@la:r            
sakje               	sAkj@               
sal                 	sAl                 
salaris             	sa:la:rIs            
samen               	sa:m@n               
sandlooper          	sAndlo:p@r           
saysoen             	sAisun              
schaaden            	sxa:d@n             
schaamt             	sxa:mt              
schaatsen           	sxa:ts@n            
schabieus           	sxa:bi2:s             
schabreuse          	sxa:br2:s@            
schade              	sxa:d@               
schaf               	sxAf                
schampere           	sxAmp@r@             
schand              	sxAnt               
scharrebier         	sxArr@bir          
schat               	sxAt                
scheelden           	sx@ld@n            
scheelen            	sx@l@n             
scheelt             	sx@lt              
scheepens           	sx@p@ns            
scheeren            	sx@@n              
scheijen            	sxEi@n              
schelmerijen        	sx@lm@rEi@n           
schenken            	sx@nk@n             
schennis            	sx@nIs              
schepen             	sx@p@n              
schepenen           	sx@p@n@n            
schermen            	sx@rm@n             
scheuren            	sx@2:r@n            
scheurt             	sx@2:rt             
scheystok           	sxEistOk            
schiefhals          	sxifhAls            
schik               	sxIk                
schol               	sxOl                
schoon              	sxo:n               
schoonder           	sxo:nd@r             
schooon             	sxo:n              
schoothondjen       	sxo:thOndj@n         
schort              	sxOrt              
schouburg           	sxAubYrx           
schouder            	sxAud@              
schouderen          	sxAud@r@n            
schout              	sxAut               
schoutbelt          	sxAutb@lt           
schouts             	sxAuts              
schouwburg          	sxAuwbYrx          
schouwen            	sxAuw@n             
schraale            	sxra:l@             
schreeuwt           	sxre:ut             
schreit             	sxrEit               
schrift             	sxrIft              
schriften           	sxrIft@n            
schrifts            	sxrIfts             
schriftuur          	sxrIftyr          
schriftuuren        	sxrIftyr@n         
schryvende          	sxriv@nd@           
schudden            	sxYd@n              
schuifjes           	sx9yfj@s            
schuil              	sx9yl               
schuilt             	sx9ylt              
schuit              	sx9yt               
schuld              	sxYlt               
schuldig            	sxYldIg             
schut               	sxYt                
schuur              	sxyr              
schuuren            	sxyr@n             
schyn               	sxin                
schynschoon         	sxInsxo:n           
schynt              	sxInt               
schyven             	sxiv@n              
se                  	s@                  
secreeten           	s@kr@t@n            
secretaris          	s@kr@ta:rIs         
sed                 	s@t                 
sedert              	s@d@rt               
seeckere            	s@k@r@               
seemelknooper       	s@m@lkno:p@r         
sellementen         	s@l@m@nt@n          
selleweeken         	s@l@w@k@n           
selve               	s@lv@               
selven              	s@lv@n              
seneca              	s@n@k               
sesde               	s@sd@               
setten              	s@t@n               
seun                	s2:n                 
sevende             	s@v@nd@             
seventien           	s@v@ntin            
sic                 	sIk                 
sig                 	sIg                 
sikken              	sIkk@n              
sileen              	sIl@n               
silency             	sIl@ns              
simon               	sImOn               
singulier           	sINylir             
sint                	sInt                
sla                 	sla:                
slaan               	sla:n               
slaande             	sla:nd@             
slaap               	sla:p               
slaapeloose         	sla:p@lo:s@         
slaapende           	sla:p@nd@           
slaat               	sla:t               
slachter            	slAxt@r              
slaen               	sla:n               
slaepen             	sla:p@n             
slampamper          	slAmpAmp@r           
slechjes            	sl@xj@s              
slecht              	sl@xt                
slechten            	sl@xt@n              
slechts             	sl@xts               
sleepen             	sl@p@n              
slegts              	sl@xts              
slendrum            	sl@ndrYm            
slet                	sl@t                
slieren             	slir@n              
sloeg               	slux                
sloof               	slo:f               
slooten             	slo:t@n             
slopje              	slOpj@              
sluit               	sl9yt               
sluiten             	sl9yt@n             
sluitende           	sl9yt@nd@           
slypen              	slip@n              
smakje              	smAkj@              
smeekt              	sm@kt               
smeeren             	sm@r@n              
smooren             	smo:r@n             
smout               	smAut               
smyten              	smit@n              
snaak               	sna:k               
snap                	snAp                
snapt               	snApt               
snavel              	snAv@l              
snede               	sn@d@               
snee                	sn@                 
snel                	sn@l                
snikkende           	snIkk@nd@           
snoepreisje         	snuprEisj@           
snol                	snOl                
snollen             	snOl@n              
snot                	snOt                
snotneus            	snOtn2:s             
snyders             	snid@rs              
so                  	so:                 
socraat             	sOkra:t             
soenen              	sun@n               
soentje             	suntj@              
soerce              	surs@               
soerzen             	surz@n              
soet                	sut                 
soetert             	sut@rt               
sollen              	sOl@n               
sondament           	sOnda:m@nt           
sonder              	sOnd@r               
soo                 	so:                 
soomers             	so:m@rs              
sot                 	sOt                 
soude               	sAud@               
souden              	sAud@n              
souveraine          	suv@rAin@           
spaak               	spa:k               
spaar               	spa:r               
spaart              	spa:rt              
specteert           	sp@kt@rt            
speelen             	sp@l@n              
speelt              	sp@lt               
spel                	sp@l                
spelkonst           	sp@lkOnst           
spelletje           	sp@l@tj@            
speult              	sp2:lt               
spillen             	spIl@n              
spit                	spIt                
splyt               	split               
splyten             	split@n             
spoeijen            	spui@n              
spoelen             	spul@n              
spoor               	spo:r               
spotten             	spOt@n              
spouwen             	spAuw@n             
sprak               	sprAk               
spreek              	spr@k               
spreeken            	spr@k@n             
spreekt             	spr@kt              
springen            	sprIN@n             
springt             	sprINt              
sprinkt             	sprInkt             
spul                	spYl                
spyt                	spit                
spyten              	spit@n              
sta                 	sta:                
staaltjes           	sta:ltj@s           
staan               	sta:n               
staat               	sta:t               
stad                	stAt                
stae                	sta:                
staeje              	sta:j@              
stael               	sta:l               
staen               	sta:n               
staet               	sta:t               
staje               	stAj@               
stand               	stAnt               
stapmen             	stApm@n             
stappen             	stApp@n             
staten              	sta:t@n              
statu               	sta:ty               
statueeren          	sta:ty@r@n            
stee                	st@                 
steeds              	st@ds               
steek               	st@k                
steeken             	st@k@n              
steelen             	st@l@n              
steelt              	st@lt               
steê               	st@                 
steên              	st@n                
stel                	st@l                
stellen             	st@l@n              
stelpen             	st@lp@n             
sterken             	st@rk@n              
sterkste            	st@rkst@             
sterren             	st@r@n              
steune              	st2:n@               
stée               	st@                 
stil                	stIl                
stille              	stIl@               
stillen             	stIl@n              
stilletjes          	stIl@tj@s           
stinken             	stInk@n             
stip                	stIp                
stoel               	stul                
stoelen             	stul@n              
stof                	stOf                
stoffe              	stOf@               
stok                	stOk                
stokslagen          	stOkslAx@n          
stokvis             	stOkvIs             
stom                	stOm                
stond               	stOnt               
stoot               	sto:t               
stoppen             	stOpp@n             
stort               	stOrt              
stoute              	stAut@              
straat              	stra:t              
straet              	stra:t              
straks              	strAks              
streelen            	str@l@n             
streelt             	str@lt              
strekken            	str@kk@n            
stronk              	strOnk              
stroo               	stro:               
stroop              	stro:p              
stryd               	strit               
stryken             	strik@n             
student             	styd@nt             
stuk                	stYk                
stukken             	stYkk@n             
stulp               	stYlp               
styf                	stif                
styn                	stin                
styven              	stiv@n              
subject             	sYbj@kt             
sul                 	sYl                 
sulks               	sYlks               
sullen              	sYl@n               
sult                	sYlt                
supplianten         	sYppliAnt@n        
swaan               	swa:n               
swaantje            	swa:ntj@            
swaantjes           	swa:ntj@s           
swaen               	swa:n               
swaentje            	swa:ntj@            
swaentjes           	swa:ntj@s           
swak                	swAk                
sweer               	sw@r                
sweeren             	sw@r@n              
sweerje             	sw@rj@              
swiet               	swit                
sy                  	si                  
syn                 	sin                 
taafél             	ta:f@l              
taal                	ta:l                
tael                	ta:l                
tafel               	tAf@l               
tafelbel            	tAf@lb@l            
taffronteeren       	tAfrOnt@r@n         
tanden              	tAnd@n              
tang                	tAN                 
tas                 	tAs                 
te                  	t@                  
teder               	t@d@r                
teedere             	t@d@r@               
teegen              	t@x@n               
teegens             	t@x@ns              
teegenspreeken      	t@x@nspr@k@n        
teemen              	t@m@n               
teer                	t@r                 
tegen               	t@x@n               
tegens              	t@x@ns              
teisteren           	tEist@r@n             
ten                 	t@n                 
ter                 	t@r                  
termineeren         	t@rmin@r@n           
terwel              	t@rw@l               
terwyl              	t@rwil               
textum              	t@xtYm               
theses              	t@s@s               
thuis               	t9ys                
thyrcis             	tIrsIs               
tmynent             	tmin@nt             
to                  	to:                 
toch                	tOx                 
toe                 	tu                  
toechaalt           	tuxa:lt             
toegemeeten         	tux@m@t@n           
toegesonden         	tux@sOnd@n          
toegestaan          	tux@sta:n           
toehoorders         	tuho:rd@rs           
toekomende          	tukOm@nd@           
toen                	tun                 
toeslaande          	tusla:nd@           
toesond             	tusOnt              
toffel              	tOf@l               
tonderdrukken       	tOnd@drYk@n        
toneele             	tOn@l@              
tong                	tON                 
tontloopen          	tOntlo:p@n          
tontveinzen         	tOntvEinz@n          
tonzent             	tOnz@nt             
toon                	to:n                
tooneel             	to:n@l              
tooneele            	to:n@l@             
tooneels            	to:n@ls             
tooneelwerken       	to:n@lw@rk@n         
toonel              	to:n@l              
toonen              	to:n@n              
toornig             	to:rnIg             
tot                 	tOt                 
traan               	tra:n               
traanen             	tra:n@n             
trad                	trAt                
traenen             	tra:n@n             
trant               	trAnt               
trappen             	trApp@n             
trapt               	trApt               
treed               	tr@t                
treeden             	tr@d@n              
treedende           	tr@d@nd@            
treên              	tr@n                
trek                	tr@k                
trekt               	tr@kt               
treuren             	tr2:r@n              
treurpellen         	tr2:rp@l@n           
treurspellen        	tr2:rsp@l@n          
treves              	tr@v@s              
triomfeeren         	trio:mf@r@n         
troost              	tro:st              
trouw               	trAuw               
trouwbeloft         	trAuwb@lOft         
trouwen             	trAuw@n             
tryn                	trin                
turf                	tYrf               
turfmand            	tYrfmAnt           
tusschen            	tYs@n              
twede               	tw@d@               
twee                	tw@                 
tweede              	tw@d@               
twie                	twi                 
twien               	twin                
twintigsten         	twIntIxst@n         
twyfflen            	twIfl@n             
tyd                 	tit                 
tydig               	tidIg               
tyds                	tids                
tyjen               	ti@n               
tys                 	tis                 
tzaam               	tza:m               
uil                 	9yl                 
uit                 	9yt                 
uiten               	9yt@n               
uitgeleid           	9ytx@lEit            
uitgemalt           	9ytx@mAlt           
uitgespeelt         	9ytx@sp@lt          
uitgezongen         	9ytx@zON@n          
uitkomst            	9ytkOmst            
uitstellen          	9ytst@l@n           
uitstorten          	9ytstOrt@n         
universiteyt        	Yniv@rsitEit          
uur                 	yr                
uuren               	yr@n               
uurtje              	yr@tj@              
uw                  	yu                  
uwent               	yu@nt               
uyt                 	9yt                 
uytgeven            	9ytx@v@n            
vaar                	va:r                
vaart               	va:rt               
vader               	vAd@r                
vaer                	va:r                
vaerdig             	va:rdIg             
vaeren              	va:r@n              
vaertj              	va:rtj              
vaertje             	va:rtj@             
vaêr               	va:r                
vaêren             	va:r@n              
vaêrtje            	va:rtj@             
vallen              	vAl@n               
vals                	vAls                
valsch              	vAls                
valt                	vAlt                
van                 	vAn                 
vanbeaumont         	vAnb@o:mOnt          
vander              	vAnd@r               
vangen              	vAN@n               
varken              	vArk@n             
varkenskot          	vArk@nskOt         
vast                	vAst                
vaste               	vAst@               
vat                 	vAt                 
vechten             	v@xt@n               
veeg                	v@x                 
veel                	v@l                 
veelen              	v@l@n               
veen                	v@n                 
veenboer            	v@nbur              
veer                	v@r                 
veeren              	v@r@n               
veertien            	v@rtin              
veeters             	v@t@rs               
veinsen             	vEins@n              
veinsende           	vEins@nd@            
veldlied            	v@ldlit             
vellen              	v@l@n               
venster             	v@nst@r              
vensters            	v@nst@rs             
vent                	v@nt                
venten              	v@nt@n              
ventje              	v@ntj@              
ver                 	v@r                  
veranderd           	v@rAnd@rt             
verandering         	v@rAnd@rIN            
verantwoorden       	v@rAntwo:rd@n        
verbeeld            	v@rb@lt              
verbeeldeenig       	v@rb@ld@nIg          
verbeeterhuis       	v@rb@t@rh9ys          
verbeuren           	v@rb2:r@n             
verbeurte           	v@rb2:rt@             
verbiedende         	v@rbid@nd@           
verblommen          	v@rblOm@n            
verbod              	v@rbOt               
verboôn            	v@rbo:n              
verbrot             	v@rbrOt              
verbruid            	v@rbr9yt             
verdedigen          	v@rd@dIx@n           
verder              	v@rd@r                
verdicht            	v@rdIxt              
verdichte           	v@rdIxt@             
verdrenken          	v@rdr@nk@n           
verdriet            	v@drit              
verdwynen           	v@rdwin@n            
vereerde            	v@r@rd@              
vereering           	v@r@rIN              
vereischt           	v@rEist              
vergaaderd          	v@rxa:d@rt            
vergaderd           	v@rxAd@rt             
vergeeten           	v@rx@t@n             
vergult             	v@rxYlt              
vergund             	v@rxYnt              
verhaal             	v@rha:l              
verhoedinge         	v@rhudIN@            
verhoên            	v@rhun               
verhoole            	v@rho:l@             
verhoolen           	v@rho:l@n            
verhoopende         	v@rho:p@nd@          
verhoor             	v@rho:r              
verifieeren         	v@rIfi@r@n            
verkeerd            	v@rk@rt              
verkeert            	v@rk@rt              
verkiesen           	v@rkis@n             
verklaard           	v@rkla:rt            
verklaaren          	v@rkla:r@n           
verklaaring         	v@rkla:rIN           
verklaring          	v@rkla:rIN           
verkogte            	v@rkOxt@             
verkoopen           	v@rko:p@n            
verkopen            	v@rkOp@n             
verkort             	v@rkOrt             
verlaat             	v@rla:t              
verlaaten           	v@rla:t@n            
verlaatende         	v@rla:t@nd@          
verlaeten           	v@rla:t@n            
verlang             	v@rlAN               
verleegen           	v@rl@x@n             
verleenen           	v@rl@n@n             
verleent            	v@rl@nt              
verleeren           	v@rl@r@n             
verlichten          	v@rlIxt@n            
verliefde           	v@rlifd@             
verliesen           	v@rlis@n             
verliezen           	v@rliz@n             
verlijen            	v@rli@n              
verloope            	v@rlo:p@             
verlooren           	v@rlo:r@n            
vermaak             	v@rma:k              
vermaek             	v@rma:k              
vermeeren           	v@rm@r@n             
vermits             	v@rmIts              
vermogen            	v@rmOx@n             
vermooren           	v@rmo:r@n            
verplicht           	v@rplIxt             
verrast             	v@rAst              
verre               	v@r@                
verschiet           	v@rsxit              
verschil            	v@rsxIl              
versjerde           	v@rsj@rd@             
versmelt            	v@rsm@lt             
versoek             	v@rsuk               
versoekende         	v@rsuk@nd@           
versoope            	v@rso:p@             
verspreijen         	v@rsprEi@n           
verstaaje           	v@rsta:i@            
verstaan            	v@rsta:n             
verstaat            	v@rsta:t             
verstaeje           	v@rsta:j@            
verstaen            	v@rsta:n             
verstaet            	v@rsta:t             
verstand            	v@rstAnt             
verstande           	v@rstAnd@            
verstommen          	v@rstOm@n            
verstooren          	v@rsto:r@n           
verstreeken         	v@rstr@k@n           
versuffen           	v@rsYf@n             
vertoond            	v@rto:nt             
vertoonen           	v@rto:n@n            
vertooners          	v@rto:n@rs            
vertoont            	v@rto:nt             
vertrekken          	v@rtr@kk@n           
vertrokken          	v@rtrOkk@n           
vertrouw            	v@rtrAuw             
vertrouwen          	v@rtrAuw@n           
verveelt            	v@rv@lt              
verwarring          	v@rwArrIN           
verwyt              	v@rwit               
verwyten            	v@rwit@n             
verzachten          	v@rzAxt@n            
verzeekerd          	v@rz@k@rt             
verzetten           	v@rz@t@n             
verzoek             	v@rzuk               
verzorgt            	v@rzOrxt            
vette               	v@t@                
veul                	v@l                 
veur                	v2:r                 
vier                	vir                 
vierde              	vird@               
vierschaar          	virsxa:r            
villen              	vIl@n               
vind                	vInt                
vinden              	vInd@n              
violenta            	vio:l@nta:          
vischryk            	vIsrik             
vissen              	vIs@n               
vleijen             	vlEi@n              
vleu                	vl2:                 
vliegen             	vlix@n              
vliegend            	vlix@nt             
vliegt              	vlixt               
vloer               	vlur                
vloo                	vlo:                
vloog               	vlo:x               
vlucht              	vlYxt               
vlugge              	vlYx@               
voddemoêr          	vOd@mur             
voddery             	vOd@ri               
voegt               	vuxt                
voel                	vul                 
voelende            	vul@nd@             
voelt               	vult                
voeren              	vur@n               
voet                	vut                 
voeten              	vut@n               
voetjes             	vutj@s              
voetteeren          	vut@r@n             
voên               	vun                 
vol                 	vOl                 
voldongen           	vOldON@n            
volg                	vOlx                
volgen              	vOlx@n              
volgende            	vOlx@nd@            
volgt               	vOlxt               
volk                	vOlk                
volkje              	vOlkj@              
volkomentlyk        	vOlko:m@ntlIk        
voltrekken          	vOltr@kk@n          
voltrokken          	vOltrOkk@n          
vond                	vOnt                
vonden              	vOnd@n              
vonnis              	vOnIs               
voogd               	vo:xt               
voor                	vo:r                
voorbaet            	vo:rba:t            
voordeel            	vo:rd@l             
vooren              	vo:r@n              
voorgemelde         	vo:rx@m@ld@         
voorheen            	vo:rh@n             
voorheenen          	vo:rh@n@n           
voorige             	vo:rIg@             
voorkoomen          	vo:rko:m@n          
voornaamentlyk      	vo:rna:m@ntlIk      
voornaamst          	vo:rna:mst          
voorsz              	vo:rs              
voort               	vo:rt               
voortgaan           	vo:rtxa:n           
voortgebracht       	vo:rtx@brAxt        
voorts              	vo:rts              
voorvallen          	vo:rvAl@n           
voorwaar            	vo:rwa:r            
voorzeeker          	vo:rz@k@r            
vorder              	vOrd@r              
vorsten             	vOrst@n            
vóor               	vo:r                
vraagen             	vra:x@n             
vrachtman           	vrAxtmAn            
vraegen             	vra:x@n             
vredelyk            	vr@d@lIk            
vreden              	vr@d@n              
vreeden             	vr@d@n              
vreemde             	vr@md@              
vreemdigheid        	vr@mdIghEit           
vrees               	vr@s                
vreezen             	vr@z@n              
vreijen             	vrEi@n              
vreijer             	vrEi@r               
vreijers            	vrEi@rs              
vreugd              	vr2:xt               
vreugde             	vr2:xd@              
vriend              	vrint               
vrienden            	vrind@n             
vriendschap         	vrindsxAp           
vrijelyk            	vri@lIk             
vrijen              	vri@n               
vrijerlyken         	vri@rlIk@n           
vrijers             	vri@rs               
vrind               	vrInt               
vrinden             	vrInd@n             
vrindschap          	vrIndsxAp           
vroedwyf            	vrudwif             
vroeg               	vrux                
vroegjes            	vruxj@s             
vroeten             	vrut@n              
vroom               	vro:m               
vroome              	vro:m@              
vrucht              	vrYxt               
vruchtbaer          	vrYxtba:r           
vry                 	vri                 
vryft               	vrIft               
vryheid             	vrihEit              
vryster             	vrIst@r              
vrysters            	vrIst@rs             
vryven              	vriv@n              
vuil                	v9yl                
vuilbaard           	v9ylba:rt           
vuile               	v9yl@               
vuist               	v9yst               
vyf                 	vif                 
vyfde               	vifd@               
vyftien             	viftin              
vygen               	vix@n               
vyven               	viv@n               
waafels             	wa:f@ls             
waagen              	wa:x@n              
waar                	wa:r                
waard               	wa:rt               
waardig             	wa:rdIg             
waaren              	wa:r@n              
waarheid            	wa:rh@t             
waarlyke            	wa:rlIk@            
waarom              	wa:rOm              
waasem              	wa:s@m              
wacht               	wAxt                
wachten             	wAxt@n              
wachtje             	wAxtj@              
waer                	wa:r                
waerdig             	wa:rdIg             
waereld             	wa:r@lt             
waergenomen         	wa:rx@no:m@n         
waerom              	wa:rOm              
waerschouw          	wa:rsxAuw           
waert               	wa:rt               
waeyen              	wa:i@n              
wakker              	wAkk@r               
wal                 	wAl                 
wambus              	wAmbYs              
wandeling           	wAnd@lIN            
wangen              	wAN@n               
wanneer             	wAn@r               
want                	wAnt                
waren               	wa:r@n              
warm                	wa:rm               
warme               	wa:rm@              
was                 	wAs                 
wassenaar           	wAs@na:r            
wat                 	wAt                 
water               	wAt@r                
waters              	wAt@rs               
watte               	wAt@                
weder               	w@d@r                
wederga             	w@d@rxa:             
wederhouden         	w@d@rhAud@n          
wederleggen         	w@d@rl@x@n           
wederlegging        	w@d@rl@xIN           
wedervraagen        	w@d@rvra:x@n         
wederzyde           	w@d@rzid@            
wederzyds           	w@d@rzIds            
weeken              	w@k@n               
weer                	w@r                 
weerom              	w@rOm               
weerparthy          	w@rpArti           
wees                	w@s                 
weesen              	w@s@n               
weesende            	w@s@nd@             
weeshuis            	w@sh9ys             
weeshuys            	w@sh9ys             
weet                	w@t                 
weeten              	w@t@n               
weetens             	w@t@ns              
weetenschap         	w@t@nsxAp           
weezen              	w@z@n               
weêr               	w@r                 
weêrom             	w@rOm               
weêrzyds           	w@rzIds             
weg                 	w@x                 
wel                 	w@l                 
weleboore           	w@l@bo:r@           
welk                	w@lk                
welke               	w@lk@               
welriekende         	w@lrik@nd@          
wer                 	w@r                  
wercken             	w@rk@n               
werd                	w@rt                 
werden              	w@rd@n               
werdende            	w@rd@nd@             
werk                	w@rk                 
werken              	w@rk@n               
werkje              	w@rkj@               
wesen               	w@s@n               
westvriesland       	w@stvrislAnt        
wet                 	w@t                 
weten               	w@t@n               
wetenschap          	w@t@nsxAp           
wetten              	w@t@n               
wickevoort          	wIk@vo:rt           
wie                 	wi                  
wieg                	wix                 
wiel                	wil                 
wiens               	wins                
wier                	wir                 
wierd               	wirt                
wil                 	wIl                 
wilje               	wIlj@               
willen              	wIl@n               
willende            	wIl@nd@             
wilspeelen          	wIlsp@l@n           
wilt                	wIlt                
winnen              	wIn@n               
wint                	wInt                
winter              	wInt@r               
wis                 	wIs                 
woekeraar           	wuk@ra:r             
wollenaajen         	wOl@na:i@n          
wond                	wOnt                
wonder              	wOnd@r               
woonen              	wo:n@n              
woord               	wo:rt               
woorden             	wo:rd@n             
word                	wOrt               
worden              	wOrd@n             
wordend             	wOrd@nt            
wordende            	wOrd@nd@           
wordje              	wOrdj@             
worreld             	wOrr@lt            
wou                 	wAu                 
wreed               	wr@t                
wroedwyf            	wrudwif             
wrong               	wrON                
wurm                	wYrm               
wy                  	wi                  
wyd                 	wit                 
wyders              	wid@rs               
wyf                 	wif                 
wyl                 	wil                 
wylje               	wIlj@               
wyn                 	win                 
wys                 	wis                 
wyse                	wis@                
wyst                	wIst                
wyvenrok            	wiv@nrOk            
wyze                	wiz@                
wyzen               	wiz@n               
wyzer               	wiz@r                
yder                	id@r                 
ygelyk              	ix@lIk              
ymand               	imAnt               
ymands              	imAnds              
ypecryt             	ip@krit             
ys                  	is                  
yverig              	iv@rIg               
zaak                	za:k                
zaaken              	za:k@n              
zaakje              	za:kj@              
zaam                	za:m                
zaamen              	za:m@n              
zaamenspraaken      	za:m@nspra:k@n      
zachjes             	zAxj@s              
zacht               	zAxt                
zachter             	zAxt@r               
zachtzinnig         	zAxtzInIg           
zaek                	za:k                
zaekje              	za:kj@              
zaem                	za:m                
zaemen              	za:m@n              
zagje               	zAxj@               
zak                 	zAk                 
zakken              	zAkk@n              
zakpyp              	zAkpip              
zal                 	zAl                 
zaligmakers         	zAlIxmAk@rs          
zalje               	zAlj@               
zalmen              	zAlm@n              
zalze               	zAlz@               
zand                	zAnt                
zat                 	zAt                 
ze                  	z@                  
zee                 	z@                  
zeeker              	z@k@r                
zeeper              	z@p@r                
zeg                 	z@x                 
zegele              	z@x@l@              
zeggen              	z@x@n               
zeggens             	z@x@ns              
zegje               	z@xj@               
zegt                	z@xt                
zei                 	zEi                  
zeid                	zEit                 
zeit                	zEit                 
zel                 	z@l                 
zelf                	z@lf                
zelfs               	z@lfs               
zelje               	z@lj@               
zelve               	z@lv@               
zelven              	z@lv@n              
zelver              	z@lv@r               
zend                	z@nt                
zes                 	z@s                 
zet                 	z@t                 
zetten              	z@t@n               
zettende            	z@t@nd@             
zeun                	z2:n                 
zeunen              	z2:n@n               
zeven               	z@v@n               
zevende             	z@v@nd@             
zich                	zIx                 
zie                 	zi                  
zien                	zin                 
ziet                	zit                 
zieter              	zit@r                
zin                 	zIn                 
zingen              	zIN@n               
zingt               	zINt                
zinnen              	zIn@n               
zinnespeelingen     	zIn@sp@lIN@n        
zit                 	zIt                 
zitplaatzen         	zItpla:tz@n         
zitten              	zIt@n               
zittens             	zIt@ns              
zo                  	zo:                 
zocht               	zOxt                
zodaanige           	zo:da:nIg@           
zoek                	zuk                 
zoen                	zun                 
zoenen              	zun@n               
zoet                	zut                 
zoete               	zut@                
zoetjes             	zutj@s              
zomtyds             	zOmtIds             
zonder              	zOnd@r               
zonderling          	zOnd@rlIN            
zonlicht            	zOnlIxt             
zonneschynen        	zOn@sxin@n          
zoon                	zo:n                
zorg                	zOrx               
zou                 	zAu                 
zoud                	zAut                
zouden              	zAud@n              
zouw                	zAuw                
zucht               	zYxt                
zuchtende           	zYxt@nd@            
zuigen              	z9yx@n              
zuikerbroodshoed    	z9yk@rbro:dshut      
zuipen              	z9yp@n              
zulk                	zYlk                
zulks               	zYlks               
zulleks             	zYl@ks              
zullen              	zYl@n               
zult                	zYlt                
zusje               	zYsj@               
zwaare              	zwa:r@              
zwaarigheid         	zwa:rIghEit           
zwaer               	zwa:r               
zwak                	zwAk                
zwarigheid          	zwa:rIghEit           
zwart               	zwArt              
zweer               	zw@r                
zweeren             	zw@r@n              
zweet               	zw@t                
zwelgen             	zw@lx@n             
zwichten            	zwIxt@n             
zwier               	zwir                
zwiertje            	zwirtj@             
zwoer               	zwur                
zwygen              	zwix@n              
zwygende            	zwix@nd@            
zy                  	zi                  
zyde                	zid@                
zyn                 	zin                 
zynd                	zint                
zynde               	zind@               
zyne                	zin@                
zynen               	zin@n               
zyt                 	zit                 
