aria		a:ria:
arieus		a:ri2:s
nu		ny
onfangt		OnfAngt
orten		Orten
wat		wAt
aakster		a:kst@r
aal		a:l
aan		a:n
aanboren	a:nbo:r@n
aandacht	a:ndAcht
aandachtig	a:ndAcht@g
aandoen		a:ndun
aangaan		a:nga:n
aangehoord	a:ng@ho:rd
aanhooren	a:nho:r@n
aanmaatige	a:nma:t@g@
aanminnig	a:nmInn@g
aanneemen	a:nne:m@n
aanschouwen	a:nschAuw@n
aanschouwers	a:nschAuw@rs
aansien		a:nsin
aanstonds	a:nstOnds
aanstootelyks	a:nsto:t@l@ks
aar		a:r
aardig		a:rd@g
aars		a:rs
aart		a:rt
aasem		a:s@m
abordeeren	a:bOrde:r@n
abraham		a:bra:hAm
absurd		AbsYrd
accedemy	Acc@de:mi
accoord		Acco:rd
accorderen	AccOrde:r@n
ach		Ach
acht		Acht
achten		Acht@n
achter		Acht@r
achtste		Achtst@
ad		Ad
adder		Add@r
adjudiceeren	Adjydice:r@n
adstrucsy	AdstrYcsi
advers		AdvErs
advocaat	Advo:ca:t
advocaaten	Advo:ca:t@n
advouëren	Advue:r@n
aen		a:n
aenzien		a:nzin
aer		a:r
aerdig		a:rd@g
aert		a:rt
aertje		a:rtj@
aêl		a:l
aêr		a:r
aêrs		a:rs
af		Af
afbyten		AfbEit@n
afeschuijert	Af@sch9y@rt
afgedaan	Afg@da:n
afgeschroffeld	Afg@schrOff@ld
afgesteeken	Afg@ste:k@n
afkaatsen	Afka:ts@n
aftemeeten	Aft@me:t@n
after		Aft@r
aftestryken	Aft@strEik@n
ageeren		a:ge:r@n
agter		Agt@r
al		Al
alberisper	Alb@rIsp@r
aldaar		Alda:r
aldien		Aldin
aldus		AldYs
alewijn		a:l@wEin
alewyn		a:l@wEin
algemeen	Alg@me:n
alias		a:liAs
alibi		a:libi
all		All
alle		All@
alleen		Alle:n
alleenig	Alle:n@g
alleman		All@mAn
allen		All@n
allerbest	All@rbEst
alles		All@s
allien		Allin
alls		Alls
alrieds		Alrids
als		Als
alsoo		Also:
altegaer	Alt@ga:r
althans		AlthAns
altoos		Alto:s
altyd		AltEid
alwaar		Alwa:r
amper		Amp@r
amsteldam	Amst@ldAm
amsterdam	Amst@rdAm
amsterdamsche	Amst@rdAmsch@
amsterdamse	Amst@rdAms@
ander		And@r
anderdeels	And@rde:ls
andere		And@r@
anderen		And@r@n
anders		And@rs
angst		Angst
anne		Ann@
antwoord	Antwo:rd
applicabel	Applica:b@l
appliceren	Applice:r@n
april		AprIl
argeweeren	Arg@we:r@n
argumenten	ArgymEnt@n
aria		a:ria:
arm		Arm
arme		Arm@
armen		Arm@n
armstoel	Armstul
as		As
asia		a:sia:
assuransje	AssyrAnsj@
attestacies	Att@sta:cis
attestacy	Att@sta:ci
attesteeren	Att@ste:r@n
aut		Aut
authoriseren	Autho:rise:r@n
authoriteyt	Autho:ritEit
avecaet		a:v@ca:t
avocaet		a:vo:ca:t
avocaeten	a:vo:ca:t@n
avond		a:vOnd

baalde		ba:ld@
baaren		ba:r@n
baeren		ba:r@n
bagatellen	ba:ga:tEll@n
bak		bAk
bakkes		bAkk@s
baldaedigheden	bAlda:d@ghe:d@n
baldus		bAldYs
balken		bAlk@n
ballen		bAll@n
balsem		bAls@m
bank		bAnk
banken		bAnk@n
barre		bArr@	
bartholus	bArtho:lYs
bassen		bAss@n
basterd		bAst@rd	
bastonneeren	bAstOnne:r@n
batavia		ba:ta:via:
bed		bEd
bedaar		b@da:r
bedaard		b@da:rd
bedanken	b@dAnk@n
bede		be:d@
bedenken	b@dEnk@n
bedieden	b@did@n
bedot		b@dOt
bedotten	b@dOtt@n
bedrooge	b@dro:g@
bedroogen	b@dro:g@n
bedryf		b@drEif
bedryten	b@drEit@n
bedryven	b@drEiv@n
beduijen	b@d9y@n
beduit		b@d9yt
beeker		be:k@r
beelt		be:lt
been		be:n
beest		be:st
beeter		be:t@r
bef		bEf
begaan		b@ga:n
begeerende	b@ge:r@nd@
begin		b@gIn
beginnen	b@gInn@n
begint		b@gInt
begraaven	b@gra:v@n
begrypen	b@grEip@n
behalven	b@hAlv@n
behandeld	b@hAnd@ld
behoesten	b@hust@n
behoord		b@ho:rd
behooren	b@ho:r@n
behoorlyk	b@ho:rl@k
behoort		b@ho:rt
bei		bEi
beid		bEid
beide		bEid@
beiden		bEid@n
beijen		bEi@n
bek		bEk
bekeeven	b@ke:v@n
beken		b@kEn
bekend		b@kEnd
bekenden	b@kEnd@n
bekennen	b@kEnn@n
bekent		b@kEnt
beklaaglyke	b@kkla:gl@k@
beklat		b@klAt
beknopt		b@knOpt
bekommerd	b@kOmm@rd
bekyken		b@kEik@n
belaaden	b@la:d@n
belaagen	b@la:g@n
belaên		b@la:n
beleedigen	b@le:d@g@n
beleezen	b@le:z@n
belet		b@lEt
beletten	b@lEtt@n
bellen		bEll@n
beloft		b@lOft
beloof		b@lo:f
beloofd		b@lo:fd
beloofje	b@lo:fj@
belooft		b@lo:ft
belooven	b@lo:v@n
bemind		b@mInd
ben		bEn
benevens	b@ne:v@ns
benieuwt	b@niut
benje		bEnj@
bennen		bEnn@n
benoemt		b@numt
benouwen	b@nAuw@n
bent		bEnt
beplyten	b@plEit@n
bepraeten	b@pra:t@n
berg		bErg
bergen		bErg@n
berger		bErg@r
bescheid	b@schEid
bescheiden	b@schEid@n
beschermheeren	b@schErmhe:r@n
bescherminge	b@schErmIng@
beschryven	b@schrEiv@n
beslaagen	b@sla:g@n
beslabben	b@slAbb@n
beslikte	b@slIkt@
beslissen	b@slIss@n
besluit		b@sl9yt
besse		bEss@
best		bEst
bestaen		b@sta:n
beste		bEst@
besteeden	b@ste:d@n
bestevaar	b@st@va:r
bestormen	b@stOrm@n
besukte		b@sYkt@
betaalen	b@ta:l@n
betaaling	b@ta:lIng
betaelen	b@ta:l@n
beticht		b@tIcht
betiên		b@tin
beuken		b2:k@n
beur		b2:r
beurs		b2:rs
beursesnijen	b2:rs@snEi@n
beurt		b2:rt
beuzelen	b2:z@l@n
bevat		b@vAt
beveelje	b@ve:lj@
bevonden	b@vOnd@n
bevoorens	b@vo:r@ns
bevrijen	b@vrEi@n
bewaart		b@wa:rt
bewerken	b@wErk@n
bewoogen	b@wo:g@n
bewys		b@wEis
bewysen		b@wEis@n
bewyzen		b@wEiz@n
bezaadigd	b@za:d@gd
bezint		b@zInt
bezoeken	b@zuk@n
bezonder	b@zOnd@r
bezwaard	b@zwa:rd
bezwaeren	b@zwa:r@n
bibliotheecq	biblio:the:cq
bichten		bIcht@n
bid		bId
bidje		bIdj@
bier		bir
billen		bIll@n
billyk		bIll@k
binje		bInj@
binnen		bInn@n
bits		bIts
blaauw		blAuw
blaân		bla:n
blad		blAd
blauwe		blAuw@
bleef		ble:f
bleek		ble:k
blind		blInd
blinden		blInd@n
bloed		blut
bloeijen	bluij@n
bloemen		blum@n
bloemfestoen	blumfEstun
bloempje	blumpj@
bloempjes	blumpj@s
bloesem		blus@m
blom		blOm
bloodshoofds	blo:dsho:fts
bloosje		blo:sj@
bly		blEi
blyf		blEif
blyft		blEift
blyk		blEik
blyken		blEik@n
blykt		blEikt
blyspeelen	blEispe:l@n
blyspel		blEispEl
blyspellen	blEispEll@n
blyven		blEiv@n
blyvende	blEiv@nd@
blyyen		blEi@n
boek		buk
boekje		bukj@
boel		bul
boenen		bun@n
boer		bur
boere		bur@
boeren		bur@n
boerin		burIn
boertjes	burtj@s
boete		but@
boeten		but@n
boevenstukken	buv@nstYkk@n
boksen		bOks@n
bolle		bOll@
bondel		bOnd@l
bondig		bOnd@g
bondige		bOnd@g@
bonk		bOnk
boode		bo:d@
boomen		bo:m@n
booter		bo:t@r
bord		bOrd
borst		bOrst
bouwen		bAuw@n
boven		bo:v@n
bovengemelde	bo:v@ng@mEld@
bovenste	bo:v@nst@
braaf		bra:f
braajen		bra:i@n
braef		bra:f
brande		brAnd@
breed		bre:d
breede		bre:d@
breek		bre:k
breeken		bre:k@n
breekspul	bre:kspYl
breekt		bre:kt
brengen		brEng@n
brengt		brEngt
breuk		br2:k
briefjes	brifj@s
brieven		briv@n
brocht		bOcht
broek		bruk
brokken		brOkk@n
brood		bro:d
brugman		brYgmAn
bruid		br9yd
bruigom		br9ygOm
bruijen		br9y@n
bruiloft	br9ylOft
bruiloften	br9ylOft@n
bruiloftsfeest	br9ylOftsfe:st
bruy		br9y
buigen		b9yg@n
buiksloot	b9ykslo:t
buiten		b9yt@n
bukken		bYkk@n
bullepees	bYll@pe:s
bundel		bYnd@l
bunschoten	bYnscho:t@n
burgemiesters	bYrg@mist@rs
burger		bYrg@r
buur		byr
buuren		byr@n
buurman		byrmAn
by		bEi
byget		bEig@t
byltje		bEiltj@
bysonder	bisOnd@r
bysondere	bisOnd@r@
byster		bEist@r
byten		bEit@n
bytje		bEitj@
byzondere	bizOnd@r@
byzonderlyk	bizOnd@rl@k
byzyn		bEizEin

cabas		ca:bAs
calangie	ca:lAngi
carel		ca:r@l
carels		ca:r@ls
cas		cAs
casus		ca:sYs
cat		cAt
catje		cAtj@
cees		ce:s
centrom		cEntrOm
cesserende	cEsse:r@nd@
claar		cla:r
claartje	cla:rtj@
cobus		co:bYs
coert		curt
collationeeren	cOlla:tio:ne:r@n
commediant	cOmme:diAnt
communi		cOmmyni
comparatie	cOmpa:ra:ti
compleet	cOmple:t
concludeer	cOnclyde:r
conclusy	cOnclysi
condemneeren	cOndEmne:r@n
confrater	cOnfra:t@r
confrere	cOnfrE:r@
conjungeeren	cOnjYnge:r@n
consente	cOnsEnt@
consenteren	cOnsEnte:r@n
continuatie	cOntinya:ti
contra		cOntra:
contrarie	cOntra:ri
contrary	cOntra:ri
converseerde	cOnv@rse:rd@
cootjes		co:tj@s
copye		co:pi@
coridon		co:ridOn
couplet		cuplEt
credit		cre:dIt
crelis		cre:lIs
cyteeren	cite:r@n

daad		da:d
daag		da:g
daanschouwers	da:nschAuw@rs
daar		da:r
daarom		da:rOm
dadvocaat	dAdvo:ca:t
daer		da:r
daerde		da:rd@
daerom		da:rOm
daet		da:t
dag		dAg
dagen		da:g@n
dak		dAk
damon		da:mOn
dan		dAn
dander		dAnd@r
dandere		dAnd@r@
dank		dAnk
dankje		dAnkj@
darde		dArd@
darme		dArm@
darrem		dArr@m
dartele		dArt@l@
das		dAs		
dat		dAt
datj		dAtj
datje		dAtj@
datmen		dAtmEn
dato		da:to:
dats		dAts
dattestanten	dAttEstAnt@n
datze		dAtz@
dauws		dAuws
davecaet	da:v@ca:t
davocaaten	da:vo:ca:t@n
de		d@
dee		de:
deed		de:d
deeden		de:d@n
deel		de:l
deele		de:l@
deen		de:n
deene		de:n@
deer		de:r
deerste		de:rst@
dees		de:s
deeze		de:z@
deezen		de:z@n
deezer		de:z@n
deezes		de:z@s
defloratie	de:flo:ra:ti
defloravit	de:flo:ra:vIt
deisch		dEisch
deischer	dEisch@r
demonstreeren	de:mOnstre:r@n
den		dEn
dende		dEnd@
denegatie	de:n@ga:ti
denk		dEnk
denken		dEnk@n
denkt		dEnkt
der		dEr
derde		dErd@
des		dEs
dese		de:s@
deselve		d@sElv@
desen		de:s@n
deugd		d2:gd
deugden		d2:gd@n
deugdzaem	d2:gdza:m
deun		d2:n
deur		d2:r
deurtrapt	d2:rtrApt
dewyl		d@wEil
deze		de:z@
dezelve		de:zElv@
dezen		de:z@n
dezer		de:z@r
dezes		de:z@s
dicam		dicAm
dicht		dIcht
dichte		dIcht@
dicteeren	dIcte:r@n
didrik		didrIk
die		di
diefje		difj@
diek		dik
dien		din
dienaar		dina:r
dienen		din@n
dienst		dinst
dienstbereiden	dinstb@rEid@n
dienste		dinst@
dient		dint
diepe		dip@
dieper		dip@r
diergelyk	dirg@lEik
dies		dis
dik		dIk
dikketons	dIkketons
dikmaals	dIkma:ls
dilay		dilE:
diminueeren	diminye:r@n
ding		dIng
dingen		dIng@n
dirk		dIrk
discoerzen	dIscurz@n
discoreeren	dIsco:re:r@n
discurreeren	dIscYrre:r@n
distinctelyk	dIstInct@l@k
itto		dItto:
doch		dOch
docht		dOcht
dochter		dOcht@r
dochters	dOcht@rs
doctoor		dOcto:r
doe		du
doeje		duj@
doek		duk
doeken		duk@n
doelen		dul@n
doen		dun
doende		dund@
doenmaals	dunma:ls
doet		dut
dog		dOg
dol		dOl
donker		dOnd@r
donnosle	dOnnOsl@
dood		do:d
doodelyk	do:d@l@k
doof		do:f
doogen		do:g@n
doolen		do:l@n
doop		do:p
door		do:r
dooren		do:r@n
doorgronden	do:rgrOnd@n
doorleezen	do:rle:z@n
dooven		do:v@n
dorp		dOrp
douwe		dAuw@
douwen		dAuw@n
draad		dra:d
draag		dra:g
draajen		dra:j@n
draaven		dra:v@n
draed		dra:d
draegen		dra:g@n
draelen		dra:l@n
drasbroek	drAsbruk
dreigt		drEigt
drek		drEk
drie		dri
drift		drIft
driften		drIft@n
drilhuis	drIlh9ys
drillen		drIll@n
dringende	drIng@nd@
drink		drInk
drinken		drInk@n
droefheid	drufhEid
droes		drus
droeve		druv@
drogen		dro:g@n
drok		drOk
drommel		drOmm@l
droog		dro:g
drooge		dro:g@
droogen		dro:g@n
drooger		dro:g
drooghals	dro:ghAls
droomde		dro:md@
droomen		dro:m@n
dropje		drOpj@
drucken		drYck@n
druilen		dr9yl@n
druipen		dr9yp@n
drukken		drYkk@n
drygt		drEigt
dubbeld		dYbb@ld
ducatons	dyca:tOns
duigen		d9yg@n
duiker		d9yk@r
duim		d9ym
duitspraak	d9ytspra:k
dun		dYn
dunkt		dYnkt
dupliceerende	dypli:ce:r@nd@
duplycq		dyplicq
durf		dYrf
durven		dYrv@n
dus		dYs
dwang		dwAng
dwars		dwArs
dwingen		dwIngen
dwong		dwOng
dyk		dEik

echt		Echt
echter		Echt@r
eclipseert	e:clIpse:rt
edelman		e:d@lmAn
ee		e:
eed		e:d
een		e:n
eenen		e:n@n
eener		e:n@r
eenig		e:n@g
eenige		e:n@g@
eenigste	e:n@gst@
eenlyk		e:nl@k
eenmaal		e:nma:l
eenmael		e:nma:l
eenpaarig	e:npa:r@g
eens		e:ns
eensdeels	e:nsde:ls
eer		e:r
eerbied		e:rbid
eerder		e:rd@r
eeren		e:r@n
eerlyk		e:rl@k
eerst		e:rst
eerste		e:rs@
eersten		e:rst@n
eertj		e:rtj
eertje		e:rtj@
eerws		e:rws
eeten		e:t@n
eeven		e:v@n
effect		EffEct
ehad		@hAd
ei		Ei
eigen		Eig@n
einde		Eind@
eindelyk	Eind@l@k
eindigt		Eind@gt
eisch		Eisch
eischer		Eisch@r
eitje		Eitj@
ekreegen	@kre:g@n
el		El
elders		Eld@rs
eleegen		@le:g@n
elk		Elk
elkaer		Elka:r
eloogen		@lo:g@n
elselaantje	Els@la:ntj@
elsje		Elsj@
elucidatie	e:lycida:ti
eluijert	e:l9y@rt	
em		Em
emalt		@mAlt
en		En
encarel		Enca:r@l
encourageeren	Encura:ge:r@n
end		End
ende		End@
enfo		Enfo:
engelgraaff	Eng@lgra:f
enkele		Enk@l@
entwintig	EntwInt@g
er		Er
erfg		Erfg
etcaetera	Etce:t@ra:
etsi		Etsi	
even		e:v@n
eveneens	e:v@ne:ns
ewent		e:wEnt
excelent	Exc@lEnt
exceptie	ExcEpti
exemplaer	Ex@mpla:r
exemplaren	Ex@mpla:r@n
exhibeeren	Exhibe:r@n
expensis	ExpEnsIs
expiratie	Expira:ti
expireren	Expire:r@n
expres		ExprEs
expresselijk	ExprEss@l@k
extensie	ExtEnsi
ey		Ei
eygenaars	Eig@na:rs
eynde		Eind@
ezeid		@zEid

faam		fa:m
fatsoen		fAtsun
february	fe:brya:ri
feeks		fe:ks
feilen		fEil@n
feit		fEit
felten		fElt@n
fiat		fiAt
figmenten	fIgmEnt@n
flap		flAp
fleemend	fle:m@nd
fleemende	fle:m@nd@
flippus		flIppYs
floor		flo:r
floortjen	flo:rtj@n
floreen		flo:re:n
fluks		flYks
fobert		fo:b@rt
foberts		fo:b@rts
foei		fui
fondament	fOnda:mEnt
foob		fo:b
forma		fOrma:
formeel		fOrme:l
fout		fAut
fraay		fra:i
freek		fre:k
frivol		frivOl
fulpe		fYlp@
fuyke		f9yk@
fymelaar	fEim@la:r
fymelaêr	fEim@la:r
fyndoek		fEinduk
fynnen		fYnn@n
fynste		fEinst@

ga		ga:
gaa		ga:
gaan		ga:n
gaande		ga:nd@
gaat		ga:t
gae		ga:
gaen		ga:n
gaer		ga:r
gaet		ga:t
gaf		gAf
gal		gAl
gang		gAng
gans		gAns
gantsch		gAntsch
gast		gAst
gat		gAt
gatje		gAtj@
gauw		gAuw
geabbrevieerde	g@Abbre:vie:rd@
geaccordeert	g@AccOrde:rt
geannulleert	g@AnnYlle:rt
gebaarden	g@ba:rd@n
gebeden		g@be:d@n
gebeên		g@be:n
gebeuren	g@b2:r@n
gebleeken	g@ble:k@n
gebleeven	g@ble:v@n
gebonden	g@bOnd@n
geboomte	g@bo:mt@
geboortestad	g@bo:rt@stAd
gebraaden	g@bra:d@n
gebracht	g@brAcht
gebrek		g@brEk
gebril		g@brIl
gebroed		g@brud
gebruycken	g@br9yck@n
geconditioneert	g@cOnditio:ne:rt
geconsenteert	g@cOnsEnte:rt
gecontraheerde	g@cOntra:he:rd@
gedaagde	g@da:gd@
gedaagden	g@da:gd@n
gedaagdes	g@da:gd@s
gedaan		g@da:n
gedacht		g@dAcht
gedachten	g@dAcht@n
gedaen		g@da:n
gedeelte	g@de:lt@
gedogen		g@do:g@n
gedooken	g@do:k@n
gedreeven	g@dre:v@n
gedroopen	g@dro:p@n
gedruckt	g@drYckt
gedruilt	g@dr9ylt
gedrukt		g@drYkt
geduld		g@dYld
geduldig	g@dYld@g
gedulds		g@dYlds
gedurende	g@dyr@nd@
geduurende	g@dyr@nd@
geef		ge:f
geeft		ge:ft
geen		ge:n
geerne		ge:rn@
geest		ge:st
geestig		ge:st@g
geeven		ge:v@n
geexamineert	g@Exa:mine:rt
geflonker	g@flOnk@r
gegaan		g@ga:n
gegeeven	g@ge:v@n
gehad		g@hAd
geheel		g@he:l
geheelt		g@he:lt
geheeten	g@he:t@n
gehouden	g@hAud@n
gehouwen	g@hAuw@n
gejouisseert	g@jAuIsse:rt
gejuig		g@j9yg
gek		gEk
gekeelt		g@ke:lt
gekkekooy	gEkk@ko:y
gekleed		g@kle:d
gekoomen	g@ko:m@n
gelaat		g@la:t
gelag		g@lAg
geld		gEld
geleden		g@le:d@n
geleeden	g@le:d@n
geleerd		g@le:rd
geleerdheid	g@le:rdhEid
geleezen	g@le:z@n
geleên		g@le:n
gelegt		g@lEgt
gelen		ge:l@n
gelet		g@lEt
geliefden	g@lifd@n
gelieven	g@liv@n
geloofbaare	g@lo:fba:r@
geloogen	g@lo:g@n
geloopen	g@lo:p@n
gelooven	g@lo:v@n
gelubde		g@lYbd@
gelyk		g@lEik
gelyken		g@lEik@n
gelykenis	g@lEik@nIs
gelykenissen	g@lEik@nIss@n
gemaakt		g@ma:kt
gemaklyk	g@mAkl@k
gemeen		g@me:n
gemoed		g@mud
gemoet		g@mut
genaamd		g@na:md
genaamt		g@na:mt
genegen		g@ne:g@n
genieten	g@nit@n
genigen		g@nig@n
genoeg		g@nug
genood		g@no:d
genoomen	g@no:m@n
genootsaakt	g@no:tsa:kt
geoctroyeert	g@Octro:ie:rt
gepaerd		g@pa:rd
gepeinzen	g@pEinz@n
gepermitteert	g@pErmItte:rd
geplaatst	g@pla:tst
gepleeten	g@ple:t@n
gepleit		g@plEit
geprocreert	g@pro:cre:rt
geproduceerd	g@pro:dyce:rt
gepromoveert	g@pro:mo:ve:rt
gepruilt	g@pr9ylt
gepurgeert	g@pYrge:rt
geraaden	g@ra:d@n
geraaken	g@ra:k@n
geraas		g@ra:s
geraekt		g@ra:kt
gerard		ge:rArd
gerecht		g@rEcht
gerechtskaamer	g@rEchtska:m@r
gereed		g@re:d
gereeden	g@re:d@n
gereegen	g@re:g@n
gerequireerdens	g@re:qire:r:rdens
gerippereert	g@rIpp@re:rt
gerust		g@rYst
gescheurt	g@sch2:rt
geschieden	g@schid@n
geschiet	g@schit
geschiên	g@schin
geschut		g@schYt
geselschap	g@sElschAp
geslacht	g@slAcht
geslagt		g@slAgt
gesloopen	g@slo:p@n
gesnap		g@snAp
gesoen		g@sun
gesol		g@Sol
gespannen	g@spAnn@n
gesprek		g@sprEk
gesprooten	g@spro:t@n
gestaan		g@sta:n
gesteld		g@stEld
gestoffeert	g@stOffe:rt
gestommel	g@stOmm@l
gestooken	g@sto:k@n
gestoolen	g@sto:l@n
gestooven	g@sto:v@n
gestort		g@stOrt
gestreeken	g@stre:k@n
gesubcenteert	g@sYbcEnte:rt
get		gEt
getalm		g@tAlm
getreeden	g@tre:d@n
getrouwd	g@trAuwd
getuigen	g@t9yg@n
getuignis	g@t9ygnIs
geurig		g2:r@g
geurige		g2:r@g@
geval		g@vAl
geven		ge:v@n
gevoerd		g@vurd
gevoert		g@vurt
gevolg		g@vOlg
gevolgt		g@vOlgt
gevonden	g@vOnd@n
geween		g@we:n
geweest		g@we:st
geweeten	g@we:t@n
geweld		g@wEld
gewis		g@wIs
gewonnen	g@wOnn@n
gezegt		g@zEgt
gezeid		g@zEid
gezelschap	g@zElschAp
gezet		g@zEt
gezicht		g@zIcht
gezien		g@zin
gien		gin
ging		gIng
gissen		gIss@n
gistren		gIstr@n
glas		glAs
godshuisen	gOdsh9ys@n
godshuysen	gOdsh9ys@n
goe		gu
goed		gud
goede		gud@
goedwilligheid	gudwIll@ghEid
goeje		guj@
gong		gOng
gooit		go:it
goosens		go:s@ns
graag		gra:g
gracy		gra:ci
graeg		gra:g
gratie		gra:ti
gratificeren	gra:tifice:r@n
grauwt		grAuwt
greep		gre:p
grillen		grIll@n
grimlacht	grImlAcht
grimmeld	grImm@ld
groen		grun
grof		grOf
grond		grOnd
gronden		grOnd@n
grondig		grOnd@g
groot		gro:t
groote		gro:t@
grootjes	gro:tj@s
grootte		gro:tt@
grote		gro:t@
grouwen		grAuw@n
grypen		grEip@n
grypt		grEipt
guil		g9yl
guilen		g9yl@n
guldens		gYld@ns
gun		gYn
gunst		gYnst
gunter		gYnt@r
gy		gEi


haalt		ha:lt
haamer		ha:m@r
haamertje	ha:m@rtj@
haamlebout	ha:ml@bAut
haan		ha:n
haantje		ha:ntj@
haar		ha:r
haard		ha:rd
haare		ha:r@
haarig		ha:r@g
haast		ha:st
haazepad	ha:z@pAd
had		hAd
hadden		hAdd@n
hady		hAdi
haelen		ha:l@n
haer		ha:r	
haeren		ha:r@n
haest		ha:st
haestig		ha:st@g
hage		ha:g@
half		hAlf
hallef		hAll@f
hals		hAls
hamer		ha:m@r
hand		hAnd
handen		hAnd@n
hangen		hAng@n
hanggat		hAnggAt
hangoor		hAngo:r
hans		hAns
hapt		hApt
hard		hArd
harde		hArd@
harder		hArd@r
harderwyk	hArd@rwEik
hare		ha:r@
haren		ha:r@n
harssendroomen	hArss@ndro:m@n
harssens	hArss@ns
hart		hArt
hartelyk	hArt@l@k
harten		hArt@n
hartseer	hArtse:r
he		h@
heb		hEb
hebbe		hEbb@
hebben		hEbb@n
hebbende	hEbb@n
hebj		hEbj
hebje		hEbj@
heblykheid	hEbl@khEid
hebt		hEbt
hebze		hEbz@
heeft		he:ft
heel		he:l
heele		he:l@
heelen		he:l@n
heemel		he:m@l
heen		he:n
heenen		he:n@n
heer		he:r
heeren		he:r@n
heerschip	he:rschAp
heggen		hEgg@n
heid		hEid
heinsius	hEinsiYs
hek		hEk
helaas		he:la:s
help		hElp
helpen		hElp@n
helpje		hElpj@
helpt		hElpt
hem		hEm
hen		hEn
hendrik		hEndrIk
henglen		hEngl@n
herberg		hErbErg
herhaalen	hErha:l@n
hervormen	hErvOrm@n
het		hEt
heunig		h2:n@g
heur		h2:r
heurs		h2:rs
hiel		hil
hiele		hil@
hier		hir
hikkende	hIkk@nd@
ho		ho:
hoe		hu
hoed		hud
hoedraakt	hudra:kt
hoeft		huft
hoer		hur
hoertje		hurtj@
hoesen		hus@n
hoewel		huwEl
hof		hOf
hoge		ho:g@
hola		ho:la:
holland		hOllAnd
homeris		ho:me:rIs
hond		hOnd
honderd		hOnd@rd
hondert		hOnd@rt
honig		ho:n@g
hoofd		ho:fd
hooft		ho:ft
hoog		ho:g
hoogen		ho:g@n
hoogsten	ho:gst@ns
hoopen		ho:p@n
hoor		ho:r
hooren		ho:r@n
hoort		ho:rt
hooy		ho:i
hop		hOp
hou		hAu
houd		hAud
houden		hAud@n
houdende	hAud@nd@
houtskool	hOutsko:l
houwen		hAuw@n
huer		hu:r
huibert		h9yb@rt
huilebalk	h9yl@bAlk
huilen		h9yl@n
huilende	h9yl@nd@
huilt		h9ylt
huis		h9ys
huizen		h9yz@n
hulp		hYlp
hun		hYn
hunne		hYnn@
huuwelyk	hyw@l@k
huuwlyk		hywl@k
huuwlyks	huwl@ks
huuwlykszaaken	hywl@ksza:k@n
hy		hEi
hyntje		hEintj@
hyze		hEiz@

ibi		ibi
iemand		i:mAnd
ien		in
iens		ins
iets		its
ik		Ik
immensis	ImmEnsIs
immermeer	Imm@rme:r
immers		Imm@rs
impartinency	ImpArtinEnci
impartinent	ImpArtinEnt
impregnavit	ImprEgna:vIt
in		In
inbeelden	Inbe:ld@n
influeren	Inflye:r@n
ingebragte	Ing@brAgt@
ingeleid	Ing@lEid
inhoude		InhAud@
injungeeren	InjYnge:r@n
inktkooker	Inktko:k@r
inne		Inn@
insonderheid	InsOnd@rhEid
interpoosen	Int@rpo:s@n
intreên		Intre:n
inwendige	InwEnd@g@
irrelevant	Irre:l@vAnt
irreprochabel	Irre:prOcha:b@l
is		Is

ja		ja:
jaagen		ja:g@n
jaap		ja:p
jaapje		ja:pj@
jaar		ja:r
jaaren		ja:r@n
jaars		ja:rs
jacht		jAcht
jachtig		jAcht@g
jacob		ja:cOb
jacobus		ja:co:bYs
jaegt		ja:gt
jaep		ja:p
jaer		ja:r
jaeren		ja:r@n
jan		jAn
janken		jAnk@n
janne		jAnn@
jannetje	jAnn@tj@
jansz		jAnsz
jaren		ja:r@n
je		j@
jegens		je:g@ns
jem		jEm
jemy		je:mi
jer		jEr
jeremias	je:r@miAs
jesse		jEss@
jet		jEt
jeugd		j2:gd
jeugdig		j2:gd@g
joachimus	jo:AchimYs
joan		jo:An
joannes		jo:Ann@s
jochem		jOch@m
jongen		jOng@n
jongmans	jOngmAns
jongspel	jOngspEl
jongspul	jOngspYl
jonker		jOnk@r
jons		jOns
joppen		jOpp@n
jorden		jOrd@n
joris		jo:rIs
jou		jAu
joului		jAul9y
jouwen		jAuw@n
jouwent		jAuw@nt
juffrouw	jYffrAuw
juist		j9yst
jy		jEi

kaamer		ka:m@r
kaameraet	ka:m@ra:t
kaamerdeur	ka:m@rd2:r
kaarsen		ka:rs@n
kaart		ka:rt
kaele		ka:l@
kaeter		ka:t@r
kal		kAl
kalf		kAlf
kamer		ka:m@r
kan		kAn
kanjuweeltje	kAnjywe:ltj@
kans		kAns
kansje		kAnsj@
kant		kAnt
kap		kAp
karel		ka:r@l
karsten		kArst@n
keel		ke:l
keeren		ke:r@n
keert		ke:rt
kees		ke:s
keijers		kEi@rs
keirel		kEir@l
ken		kEn
kenje		kEnj@
kennis		kEnnIs
kent		kEnt
keunings	k2:nIngs
keuninklyk	k2:nInkl@k
keunje		k2:nj@
kies		kis
kikvorschen	kIkvOrsch@n
kind		kInd
kinders		kInd@rs
kindsgebeenten	kIndsg@be:nt@n
kinkel		kInk@l
kinkels		kInk@ls
klaar		kla:r
klaare		kla:r@
klaarheid	kla:rhEid
klaarleid	kla:rlEid
klaartje	kla:rtj@
klacht		klAcht
klachten	klAcht@n
klad		klAd
kladde		klAdd@
klaer		kla:r
klaeren		kla:r@n
klappen		klApp@n
kleeren		kle:r@n
kleêren		kle:r@n
klein		klEin
klerk		klErk
kleutergeld	kl2:t@rgEld
klompen		klOmp@n
klop		klOp
kloppen		klOpp@n
kloppende	klOpp@nd@
klopt		klOpt
klouwen		klAuw@n
kluchten	klYcht@n
kluchtspel	klYchtspEl
kluiten		kl9yt@n
knaphandig	knAphAnd@g
kneep		kne:p
kneepen		kne:p@n
kneppels	knEpp@ls
kneukels	kn2:k@ls
knie		kni
knier		knir
kniertje	knirtj@
knikkebeen	knIkk@be:n
knikkende	knIkk@nd@
knikkerbil	knIkk@rbIl
knikt		knIkt
knoesten	knust@n
knol		knOl
knollen		knOll@n
knolles		knOll@s
knoppen		knOpp@n
knorrepot	knOrr@pOt
koek		kuk
koeken		kuk@n
kom		kOm
komen		ko:m@n
komje		kOmj@
kommer		kOmm@r
komt		kOmt
kon		kOn
koningen	ko:nIng@n
kool		ko:l
koomen		ko:m@n
koop		ko:p
koos		ko:s
koot		ko:t
kop		kOp
koppelaar	kOpp@la:r
kort		kOrst
kortswylige	kOrstwEil@g@
kosten		kOst@n
koud		kAud
kraag		kra:g
kraajen		kra:j@n
kraam		kra:m
kraamer		kra:m@r
kraamtyd	kra:mtEid
krabben		krAbb@n
kracht		krAcht
krachten	krAcht@n
kraeken		kra:k@n
kreeg		kre:g
kreek		kre:k
krenken		krEnk@n
krenten		krEnt@n
krieken		krik@n
krielen		kril@n
krioelen	kriul@n
kruipen		kr9yp@n
kruis		kr9ys
krukken		krYkk@n
krygen		krEig@n
krygende	krEig@nd@
krygt		krEigt
kryn		krEin
krynen		krEin@n
kryns		krEins
krynvaar	krEinva:r
kunnen		kYnn@n
kunst		kYnst
kunt		kYnt
kusje		kYsj@
kusjes		kYsj@s
kusschen	kYssch@n
kwaad		kwa:d
kwaaker		kwa:k@r
kwae		kwa:
kwalyk		kwa:l@k
kwam		kwAm
kwast		kwAst
kwellen		kwEll@n
kwyl		kwEil
kwyt		kwEit
kyk		kEik
kyken		kEik@n
kykt		kEikt
kykuit		kEik9yt
kynd		kEind
kyven		kEiv@n

laan		la:n
laat		la:t
laaten		la:t@n
laater		la:t@r
laatste		la:tst@
laazen		la:z@n
lachen		lAch@n
laelyk		la:l@k
laen		la:n
laet		la:t
laeten		la:t@n
lag		lAg
lam		lAm
land		lAnd
lande		lAnd@
landen		lAnd@n
lang		lAng
lange		lAng@
langer		lAng@r
langs		lAngs
langzaam	lAngza:m
lap		lAp
lapje		lApj@
las		lAs
laste		lAst@
lasten		lAst@n
lasteraar	lAst@ra:r
latona		la:to:na:
lavement	la:v@mEnt
ledig		le:d@g
leed		le:d
leeger		le:g@r
leek		le:k
leelyk		le:l@k
leen		le:n
leendert	le:nd@rt
leeren		le:r@n
leert		le:rt
leest		le:st
leeven		le:v@n
leevens		le:v@ns
leever		le:v@r
leezen		le:z@n
leg		lEg
leggen		lEgg@n
legt		lEgt
lei		lEi
leid		lEid
leijen		lEi@n
leit		lEit
lenden		lEnd@n
leonard		le:o:nArd
lest		lEst
letten		lEtt@n
leyden		lEid@n
licenciaat	licEncia:t
licht		lIcht
lichte		lIcht@
lichten		lIcht@n
lichtlyk	lIchtl@k
lieden		lid@n
liedje		lidj@
lief		lif
liefd		lifd
liefde		lifd@
liefdens	lifd@ns
lieffelyke	liff@l@k@
liefkoost	lifko:st	
liefst		lifst
liep		lip
liet		lit
lieve		liv@
liever		liv@r
liên		lin
ligt		lIgt
lijen		lEi@n
likken		lIkk@n
linden		lInd@n
lippen		lIpp@n
loeren		lur@n
loerend		lur@nd
lompe		lOmp@
lompen		lOmp@n
loof		lo:f
loogen		lo:g@n
loopen		lo:p@n
looper		lo:p@r
los		lOs
lossen		lOss@n
louwtjens	lAuwtj@ns
lubben		lYbb@n
lucht		lYcht
luchten		lYcht@n
luchtig		lYcht@g
luidkeels	l9ydke:ls
luimen		l9ym@n
luisenek	l9ys@nEk
luisenseaet	l9ys@nse:a:t
luister		l9yst@r
luistren	l9ystr@n
luitjes		l9ytj@s
lukken		lYkk@n
lust		lYst
lustig		lYst@g
luy		l9y
luyster		l9yst@r
ly		lEi
lyd		lEid
lydde		lEidd@
lyden		lEid@n
lyf		lEif
lyjen		lEij@n
lyk		lEik
lykt		lEikt
lywaat		lEiwa:t

maag		ma:g
maak		ma:k
maaken		ma:k@n
maakende	ma:k@nd@
maakje		ma:kj@
maakt		ma:kt
maal		ma:l
maand		ma:nd
maanden		ma:nd@n
maanlicht	ma:nlIcht
maar		ma:r
macht		mAcht
maek		ma:k
maeken		ma:k@n
maekt		ma:kt
maenen		ma:n@n
maer		ma:r
maet		ma:t
mag		mAg
magt		mAgt
mai		mAi
maken		ma:k@n
mal		mAl
malkaar		mAlka:r
malkander	mAlkAnd@r
malkanderen	mAlkAnd@r@n
malkanderens	mAlkAnd@r@ns
malle		mAll@
mallen		mAll@n
man		mAn
mand		mAnd
manden		mAnd@n
mannen		mAnn@n
mannenbroek	mAnn@nbruk
mannenhuis	mAnn@nh9ys
mannenhuys	mAnnenh9ys
mans		mAns
manu		ma:ny
maski		mAski
mat		mAt
materie		ma:te:ri
matrimony	ma:trimo:ni
me		m@
mede		me:d@
medely		me:d@lEi
mee		me:
meed		me:d
meede		me:d@
meedoogend	me:do:g@nd
meen		me:n
meenen		me:n@n
meening		me:nIng
meenj		me:nj
meent		me:nt
meer		me:r
meerder		me:rd@r
meest		me:st
meeste		me:st@
meesten		me:st@n
meester		me:st@r
meesters	me:st@rs
meeters		me:t@rs
meezen		me:z@n
meê		me:
meêr		me:r
meid		mEid
meisje		mEisj@
meisjes		mEisj@s
mekaer		m@ka:r
melis		me:lIs
men		mEn
menageeren	me:na:ge:r@n
menig		me:n
menigmaalen	me:nIgma:l@n
menschen	mEnsch@n
mensk		mEnsk
mentie		mEnti
mer		mEr
merken		mErk@n
met		mEt
meug		m2:g
meugje		m2:gj@
meugt		m2:gt
middels		mIdd@ls
midden		mIdd@n
middlen		mIddl@n
mien		min
mies		mis
min		mIn
minder		mInd@r
minnelusjes	mInn@lYsj@s
minneviertje	mInn@virtj@
minst		mInst
minste		mInst@	
minsten		mInst@n
mis		mIs
misdaan		mIsda:n
misdryven	mIsdrEiv@n
misduiden	mIsd9yd@n
misschien	mIsschin
missen		mIss@n
mits		mIts
mitsgaders	mItsga:d@r
mitsgarder	mItsgArd@r
mocht		mOcht
moe		mu
moed		mud
moeilyk		muil@k
moeiten		muit@n
moer		mur
moertje		murtj@
moest		must
moesten		must@n
moet		mut
moeten		mut@n
moezen		muz@n
moêr		mur
mogen		mo:g@n
mogten		mOgt@n
mompelende	mOmp@l@nd@
mompelt		mOmp@lt
momus		mo:mYs
mond		mOnd
monde		mOnd@
moogelyk	mo:g@l@k
moogen		mo:g@n
moogje		mo:gj@
mooglyk		mo:gl@k
mooi		mo:i
mooije		mo:ij@
mooy		mo:i
morgen		mOrg@n
morgens		mOrg@ns
mortje		mOrtj@
mostert		mOst@rt
mouw		mAuw			
muffen		mYff@n
munt		mYnt
murruwer	mYrryu@r
murw		mYrw
musicaale	mysica:l@
my		mEi
myn		mEin
myne		mEin@
myner		mEin@r
myns		mEins

na		na:
naaden		na:d@n
naajen		na:j@n
naakt		na:kt
naakte		na:kt@
naam		na:m
naar		na:r
naargedruckt	na:rg@drYckt
naargedruckte	na:rg@drYckt@
naast		na:st
nacht		nAcht
nadeel		na:de:l
nader		na:d@r
nadrukken	na:drYkk@n
nae		na:
naer		na:r
naêr		na:r
nagel		na:g@l
narree		nArre:
naspreekende	na:spree:k@nd@
nauw		nAuw
nederigheid	ne:d@r@ghEid
neel		ne:l
neeltje		ne:lt@
neemen		ne:m@n
neemje		ne:mj@
neemt		ne:mt
neen		ne:n
neer		ne:r
neerduitsch	ne:rd9ytsch
neet		ne:t
neêrgeset	ne:rg@sEt
nemaar		ne:ma:r
nemen		ne:m@n
net		nEt
netjes		nEtj@s
neus		n2:s
neusdoek	n2:sduk
neutekraaker	n2:t@kra:k@r
neuten		n2:t@n
nevens		ne:v@ns
niemand		nimAnd
niet		nit
niets		nits
nieuwe		niu
noch		nOch
noem		num
noemen		num@n
noemt		numt
nog		nOg
nood		no:d
noodig		no:d@g
noodje		no:dj@
nooit		no:it
notaris		no:ta:rIs
nou		nAu
november	no:vEmb@r
nu		ny
nut		nYt
nuyts		n9yts
nygende		nEig@nd@

och		Och
octroy		Octro:i
octroye		Octro:i@
octroyeren	Octro:ie:r@n
of		Of
officier	Officir
ofte		Oft@
olyk		o:l@k
om		Om
omissie		o:mIssi
omkeeren	Omke:r@n
omme		Omm@
omni		Omni
omtrent		OmtrEnt
onbehoorlyks	Onb@ho:rl@ks
onbekrompen	Onb@krOmp@n
onbewust	Onb@wYst
onder		Ond@r
onderdanig	Ond@rda:n@g
onderschryven	Ond@rschrEiv@n
onderst		Ond@rst
ondertusschen	Ond@rtYssch@n
ondervonden	Ond@rvOnd@n
onderweeg	Ond@rwe:g
onderwerp	Ond@rwErp
onderwinden	Ond@rwInd@n
onderwyl	Ond@rwEil
onderwylen	Ond@rwEil@n
ongderhouwen	Ond@rhAuw@n
ongevraagd	Ong@vra:gd
ongzent		OngzEnt
onheblyks	OnhEbl@ks
onlangs		OnlAngs
onmoogelyk	Onmo:g@l@k
onmooglyk	Onmo:gl@k
onnoodig	Onno:d@g
onnoosle	Onno:sl@
onnopsle	OnnOpsl@
onnut		OnnYt
ons		Ons
onse		Ons@
onsen		Ons@n
onses		Ons@s
onsmaaklyk	Onsma:kl@k
ontbreeken	Ontbre:k@n
ontdekken	OntdEkk@n
onteeren	Onte:r@n
onthoud		OnthAud
ontkennen	OntkEkk@n
ontkleed	Ontkle:d
ontlooken	Ontlo:k@n
ontloopen	Ontlo:p@n
ontmoet		Ontmut
ontmoetende	Ontmut@nd@
ontroofd	Ontro:fd
ontrooven	Ontro:v@n
ontvrachten	OntvrAcht@n
onty		OntEi
ontydig		OntEid@g
ontzeggen	OntzEgg@n
ontzegging	OntzEggIng
ontzegt		OntzEgt
onwilligheid	OnwIll@ghEid
onze		Onz@
onzen		Onz@n
oog		o:g
oogen		o:g@n
oogwit		o:gwIt
ooit		o:it
ook		o:k
oordeelt	o:rde:lt
ooren		o:r@n	
oorsprong	o:rsprOng
oorzaak		o:rza:k
oost		o:st
op		Op
opdragt		OpdrAgt
open		o:p@n
openbaeren	o:p@nba:r@n
opende		o:p@nd@
opereeren	o:p@re:r@n
opgaan		Opga:n
opgepast	Opg@pAsst
opgepropt	Opg@prOpt
opgeschort	Opg@schOrt
opgetoogen	Opg@to:g@n
opgetooid	Opg@to:id
opmerking	OpmErkIng
oprecht		OprEcht
oprechtende	OprEcht@nd@
opschrift	OpschrIft
opslaan		Opsla:n
opstaande	Opsta:nd@
opstond		OpstOnd
opstonds	OpstOnds
ordinary	Ordina:ri
ordonnantie	OrdOnnAnti
ordonneeren	OrdOnne:r@n
oreeren		o:re:r@n
otten		Ott@n
oude		Aud@
ouden		Aud@n
ouderloose	Aud@rlo:s@
ouwe		Auw@
ouwerwetse	Auw@rwEts@
over		o:v@r
overboodig	o:v@rbo:d@g
overende	o:v@r@nd@
overgemerckt	o:v@rg@mErckt
overlang	o:v@rlAng
overleggen	o:v@rlEgg@n
overluid	o:v@rl9yd
overschaduwen	o:v@rscha:diu@n
overslaan	o:v@rsla:n
overweegen	o:v@rwe:g@n
ô		O

paait		pa:it
paal		pa:l
paar		pa:r
paardje		pa:rdj@
paars		pa:rs
paciensy	pa:ci:nsi
pacquet		pAcquEt
pad		pAd
paer		pa:r
paeren		pa:r@n
pak		pAk
pakje		pAkj@
pampieren	pAmpir@n
pan		pAn
papier		pApir
papieren	pApir@n
papiertjes	pApirtj@s
part		pArt
parthy		pArthEi
parthyen	pArthEi@n	
parthys		pArthEis
particulier	pArticylir
party		pArtEi
partyen		pArtEi@n
pas		pAs
passe		pAss@
passeeren	pAsse:r@n
peis		pEis
penen		pe:n@n
pennen		pEnn@n
penning		pEnnIng
periode		pe:rio:d@
persisteeren	pErsIste:r@n	
peur		p2:r
peurd		p2:rd
phlegmatiecq	phlEgma:ticq
piek		pik
pier		pir
piet		pit
pieter		pit@r
pik		pIk
pikken		pIkk@n
pinkster	pInkst@r
pislap		pIslAp
plaagen		pla:g@n
plaas		pla:s
plaats		pla:ts
plaatsen	pla:ts@n
plaets		pla:ts@n
plag		plAg
plaisier	plE:sir
plakt		plAkt
plat		plAt
platte		plAtt@
pleeg		ple:g
pleidooijeeren	plEido:ije:r@n
pleidooijen	plEido:j@n	
pleidooy	plEido:i
pleidoyeeren	plEido:ije:r@n
pleit		plEit
pleiten		plEit@n
pleiters	plEit@rs
pleitrok	plEitrOk
pleitzak	plEitzAk
pluimer		pl9ym@r
pluist		pl9yst
plukken		plYkk@n
pluwier		pliuir
plyt		plEit
plyten		plEit@n	
poelsnip	pulsnIp
poen		pun
poene		pun@
poëtiecque	po:e:ticqu@
pollen		pOll@n
ponzekoek	pOnz@kuk
poogt		po:gt
pooijen		po:ij@n
poosen		po:s@n
poot		po:t
pooten		po:t@n
post		pOst
pot		pOt
praat		pra:t
praaten		pra:t@n
praatende	pra:t@nd@
praater		pra:t@r
prachen		prAch@n
praesertim	pra:sErtIm
praet		pra:t
praeten		pra:t@n
praetjes	pra:tj@s
precautioneel	pre:cAutio:ne:l
prepareeren	pre:pa:re:r@n
presentacy	pre:sEnta:ci
president	pre:sidEnt
presidents	pre:sidEnts
preutse		pr2:ts@
prezident	pre:zidEnt
primis		primIs
primo		primo:
prinsedent	prIns@dEnt
privilegie	privile:gi
probeeren	pro:be:r@n
procedant	pro:c@dAnt
proces		pro:cEs
processe	pro:cEss@
procureurs	pro:cyr2:rs
produceeren	pro:dyce:r@n
prolix		pro:lIx
prolongatie	pro:lOnga:ti
pronuncieeren	pro:nYncie:r@n
proppen		prOpp@n
prossedeeren	prOss@de:r@n
protextie	pro:tExti
pruimen		pr9ym@n
prulle		prYll@
prullen		prYll@n
pry		prEi
prykt		prEikt
prys		prEis
prytje		prEitj@
pryzen		prEiz@n
publyk		pyblik
puit		p9yt
puiterveen	p9yt@rve:n
puiterveenen	p9yt@rve:n@n		
punt		pYnt
puur		pyr		

qua		qua:
qualitate	qua:lita:t@
qualiteit	qua:litEit
qualiteyt	qua:litEit
quartus		quArtYs
quid		quId

raad		ra:d
raaken		ra:k@n
raakend		ra:k@nd
raakt		ra:kt
raakte		ra:kt@
raar		ra:r
rabbelende	rAbb@l@nd@
raed		ra:d
raeken		ra:k@n
raekje		ra:kj@
raekt		ra:kt
raet		ra:t
raên		ra:n
randen		rAnd@n
rang		rAng
rangeeren	rAnge:r@n
rank		rAnk
ranken		rAnk@n
rapsody		rApso:di
rebel		r@bEl
recht		rEcht
rechtbank	rEchtbAnk
rechtbankzaamen	rEchtbAnkza:m@n
rechte		rEcht@
rechten		rEcht@n
rechter		rEcht@r
rechters	rEcht@rs
rechthuis	rEchth9ys
rechts		rEchts
rechtsgeding	rEchtsg@dIng
rechtsgedingen	rEchtsg@dIng@n
rechtsgeleerden	rEchtsg@le:rd@n
rechtskaamer	rEchtska:m@r
recitatief	re:cita:tif
ree		re:
reede		re:d@
reeden		re:d@n
reedenen	re:d@n@n
reeds		re:ds
reets		re:ts
reên		re:n
refuseeren	re:fyse:r@n
regenten	r@gEnt@n
reinigen	rEin@g@n
reis		rEis
reparatie	re:pa:ra:ti
repje		rEpj@
repliceerende	re:plice:r@nd@
repliek		r@plik
replycq		r@plicq
reproche	r@prOch@
reputatie	re:pyta:ti
requirant	reqwirAnt
respective	rEspEctiv@
rest		rEst
resterende	rEste:r@nd@
resumeeren	re:syme:r@n
resumptie	re:sYmpti
ribben		rIbb@n
rinkelrooijen	rInk@lro:ij@n
rispeteeren	rIsp@te:r@n
roeijen		ruij@n
roep		rup
roept		rupt
roeren		rur@n
rogge		rOgg@
rok		rOk
rolle		rOll@
rond		rOnd
ronde		rOnd@
rondom		rOndOm
rooseknopje	ro:s@knOpj@
roosen		ro:s@n
roosje		ro:sj@
rooven		ro:v@n
rouwen		rAuw@n
rubben		rYbb@n
ruchtbaer	rYchtba:r
ruikt		r9ykt
ruim		r9ym
rust		rYst
rustelyk	rYst@l@k
ryke		rEik@
ryksdaalders	rEiksda:ld@rs
rylt		rEilt
rype		rEip@
ryzen		rEiz@n

saacke		sa:ck@
saam		sa:m
sabben		sAbb@n
saemen		sa:m@n
saggelaer	sAgg@la:r
sakje		sAkj@
sal		sAl
salaris		sa:la:rIs
samen		sa:m@n
sandlooper	sAndlo:p@r
saysoen		sE:sun
schaaden	schAnd@n
schaamt		scha:mt
schaatsen	scha:ts@n
schabieus	scha:bi2:s
schabreuse	scha:br2:s@
schade		scha:d@
schaf		schAf
schampere	schAmp@r@
schand		schAnd
scharrebier	schArr@bir
schat		schAt
scheelden	sche:ld@n
scheelen	sche:l@n
scheelt		sche:lt
scheepens	sche:p@ns
scheeren	sche:r@n
scheijen	schEi@n
schelmerijen	schElm@rEi@n
schenken	schEnk@n
schennis	schEnnIs
schepen		sche:p@n
schepenen	sche:p@n@n
schermen	schErm@n
scheuren	sch2:r@n
scheurt		sch2:rt
scheystok	schEistOk
schiefhals	schifhAls
schik		schIk
schol		schOl
schoon		scho:n
schoonder	scho:nOnder
schooon		scho:n
schoothondjen	scho:thOndj@n
schort		schOrt
schouburg	schAubYrg
schouder	schAud@r
schouderen	schAud@r@n
schout		schAut
schoutbelt	schAutbElt
schouts		schAuts
schouwburg	schAuwbYrg
schouwen	schAuw@n
schraale	schra:l@
schreeuwt	schre:ut
schreit		schrEit
schrift		schrIft
schriften	schrIft@n
schrifts	schrIfts
schriftuur	schrIftyr
schriftuuren	schrIftyr@n
schryvende	schEiv@nd@
schudden	schYdd@n
schuifjes	sch9yfj@s
schuil		sch9yl
schuilt		sch9ylt
schuit		sch9yt
schuld		schYld
schuldig	schYld@g
schut		schYt
schuur		schur
schuuren	schur@n
schyn		schEin
schynschoon	schEinscho:n
schynt		schEint
schyven		schEiv@n
se		se:
secreeten	se:cre:t@n
secretaris	se:cre:ta:rIs
sed		sEd
sedert		se:d@rt
seeckere	se:k@r@
seemelknooper	se:m@lkno:p@r
sellementen	sEll@mEnt@n
selleweeken	sEll@we:k@n
selve		sElv@
selven		sElv@n
seneca		se:ne:ca:
sesde		sEsd@
setten		sEtt@n
seun		s2:n
sevende		se:v@nd@
seventien	se:v@ntin
sic		sIc
sig		sIg
sikken		sIkk@n
sileen		sile:n
silency		silEnci
simon		simOn
singulier	sIngylir
sint		sInt
sla		sla:
slaan		sla:n
slaande		sla:nd@
slaap		sla:p
slaapeloose	sla:p@lo:s@
slaapende	sla:p@nd@
slaat		sla:t
slachter	slAcht@r
slaen		sla:n
slaepen		sla:p@n
slampamper	slAmpAmp@r
slechjes	slEchj@s
slecht		slEcht
slechten	slEcht@n
slechts		slEchts
sleepen		sle:p@n
slegts		slEgts
slendrum	slEndrYm
slet		slEt
slieren		slir@n
sloeg		slug
sloof		slo:f
slooten		slo:t@n
slopje		slOpj@
sluit		sl9yt
sluiten		sl9yt@n
sluitende	sl9yt@nd@
slypen		slEip@n
smakje		smAkj@
smeekt		sme:kt
smeeren		sme:r@n
smooren		smo:r@n
smout		smAut
smyten		smEit@n
snaak		sna:k
snap		snAp
snapt		snApt
snavel		sna:v@l
snede		sne:d@
snee		sne:
snel		snEl
snikkende	snIkk@nd@
snoepreisje	snuprEisj@
snol		snOl
snollen		snOll@n
snot		snOt
snotneus	snOtn2:s
snyders		snEid@rs
so		so:
socraat		so:cra:t
soenen		sun@n
soentje		suntj@
soerce		surc@
soerzen		surz@n
soet		sut
soetert		sut@rt
sollen		sOll@n
sondament	sOnda:mEnt
sonder		sOnd@r
soo		so:
soomers		so:m@rs
sot		sOt
soude		sAud@
souden		sAud@n
souveraine	suv@rE:n@
spaak		spa:k
spaar		spa:r
spaart		spa:rt
specteert	spEcte:rt
speelen		spe:l@n
speelt		spe:lt
spel		spEl
spelkonst	spElkOnst
spelletje	spEll@tj@
speult		sp2:lt
spillen		spIll@n
spit		spIt
splyt		splEit
splyten		splEit@n
spoeijen	spui@n
spoelen		spul@n
spoor		spo:r
spotten		spOtt@n
spouwen		spAuw@n
sprak		sprAk
spreek		spre:k
spreeken	spre:k@n
spreekt		spre:kt
springen	sprIng@n
springt		sprIngt
sprinkt		sprInkt
spul		spYl
spyt		spEit
spyten		spEit@n
sta		sta:
staaltjes	sta:ltj@s
staan		sta:n
staat		sta:t
stad		stAd
stae		sta:
staeje		sta:j@
stael		sta:l
staen		sta:n
staet		sta:t
staje		sta:j@
stand		stAnd
stapmen		stApmEn
stappen		stApp@n
staten		sta:t@n
statu		sta:ty
statueeren	sta:tye:rd@n
stee		ste:
steeds		ste:ds
steek		ste:k
steeken		ste:k@n
steelen		ste:l@n
steelt		ste:lt
steê		ste:
steên		ste:n
stel		stEl
stellen		stEll@n
stelpen		stElp@n
sterken		stErk@n
sterkste	stErkst@
sterren		stErr@n
steune		st2:n@
stée		ste:
stil		stIl
stille		stIll@
stillen		stIll@n
stilletjes	stIll@tj@s
stinken		stInk@n
stip		stIp
stoel		stul
stoelen		stul@n
stof		stOf
stoffe		stOff@
stok		stOk
stokslagen	stOksla:g@n
stokvis		stOkvIs
stom		stOm
stond		stOnd
stoot		sto:t
stoppen		stOpp@n
stort		stOrt
stoute		stAut@
straat		stra:t	
straet		stra:t
straks		strAks
streelen	stre:l@n
streelt		stre:lt
strekken	strEkk@n
stronk		strOnk
stroo		stro:
stroop		stro:p
stryd		strEid
stryken		strEik@n
student		stydEnt
stuk		stYk
stukken		stYkk@n
stulp		stYlp
styf		stEif
styn		stEin
styven		stEiv@n
subject		sYbjEct
sul		sYl
sulks		sYlks
sullen		sYll@n
sult		sYlt
supplianten	sYppliAnt@n
swaan		swa:n
swaantje	swa:ntj@
swaantjes	swa:ntj@s
swaen		swa:n
swaentje	swa:ntj@
swaentjes	swa:ntj@s
swak		swAk
sweer		swe:r
sweeren		swe:r@n
sweerje		swe:rj@
swiet		swit
sy		sEi
syn		sEin

taafél		ta:f@l		?
taal		ta:l
tael		ta:l
tafel		ta:f@l
tafelbel	ta:f@lbEl
taffronteeren	tAffrOnte:r@n
tanden		tAnd@n
tang		tAng
tas		tAs
te		t@
teder		te:d@r
teedere		te:d@r@
teegen		te:g@n
teegens		te:g@ns
teegenspreeken	te:g@nspre:k@n
teemen		te:m@n
teer		te:r
tegen		te:g@n
tegens		te:g@ns
teisteren	tEist@r@n
ten		tEn
ter		tEr
termineeren	tErmine:r@n
terwel		tErwEl
terwyl		tErwEil
textum		tExtYm
theses		the:s@s
thuis		th9ys
thyrcis		thircIs
tmynent		tmEin@nt
to		to:
toch		tOch
toe		tu
toechaalt	tucha:lt
toegemeeten	tug@me:t@n
toegesonden	tug@sOnd@n
toegestaan	tug@sta:n
toehoorders	tuho:rd@rs
toekomende	tuko:m@nd@
toen		tun
toeslaande	tusla:nd@
toesond		tusOnd
toffel		tOff@l
tonderdrukken	tOnd@rdrYkk@n
toneele		to:ne:l
tong		tOng
tontloopen	tOntlo:p@n
tontveinzen	tOntvEinz@n
tonzent		tOnzEnt
toon		to:n
tooneel		to:ne:l
tooneele	to:ne:l@
tooneels	to:ne:ls
tooneelwerken	to:ne:lwErk@n
toonel		to:nEl
toonen		to:n@n
toornig		to:rn@g
tot		tOt
traan		tra:n
traanen		tra:n@n
trad		trAd
traenen		tra:n@n
trant		trAnt
trappen		trApp@n
trapt		trApt
treed		tre:d
treeden		tre:d@n
treedende	tre:d@nd@
treên		tre:n
trek		trEk
trekt		trEkt
treuren		tr2:r@n
treurpellen	tr2:rpEll@n
treurspellen	tr2:rspEll@n
treves		tre:v@s
triomfeeren	triOmfe:r@n
troost		tro:st
trouw		trAuw
trouwbeloft	trAuwb@lOft
trouwen		trAuw@n
tryn		trEin
turf		tYrf
turfmand	tYrfmAnd
tusschen	tYssch@n
twede		twe:d@
twee		twe:
tweede		twe:d@
twie		twi
twien		twin
twintigsten	twInt@gst@n
twyfflen	twEiffl@n
tyd		tEid
tydig		tEid@g
tyds		tEids
tyjen		tEij@n
tys		tEis
tzaam		tza:m

uil		9yl
uit		9yt
uiten		9yt@n
uitgeleid	9ytg@lEid
uitgemalt	9ytg@mAlt
uitgespeelt	9ytg@spe:lt
uitgezongen	9ytg@zOng@n
uitkomst	9ytkOmst
uitstellen	9ytstEll@n
uitstorten	9ytstOrt@n
universiteyt	ynivErsitEit
uur		yr
uuren		yr@n
uurtje		urtj@
uw		yu
uwent		yu@nt
uyt		9yt
uytgeven	9ytge:v@n
vaar		va:r
vaart		va:rt
vader		va:d@r
vaer		va:r
vaerdig		va:rd@g
vaeren		va:r@n
vaertj		va:rtj
vaertje		va:rtj@
vaêr		va:r
vaêren		va:r@n
vaêrtje		va:rtj@
vallen		vAll@n
vals		vAls
valsch		vAlsch
valt		vAlt
van		vAn
vanbeaumont	vAnbo:mOnt
vander		vAnd@r
vangen		vAng@n
varken		vArk@n
varkenskot	vArk@nskOt
vast		vAst
vaste		vAst@
vat		vAt
vechten		vEcht@n
veeg		ve:g
veel		ve:l
veelen		ve:l@n
veen		ve:n
veenboer	ve:nbur
veer		ve:r
veeren		ve:r@n
veertien	ve:rtin
veeters		ve:t@rs
veinsen		vEins@n
veinsende	vEins@nd@
veldlied	vEldlid
vellen		vEll@n
venster		vEnst@r
vensters	vEnst@rs
vent		vEnt
venten		vEnt@n
ventje		vEntj@
ver		vEr
veranderd	v@rAnd@rd
verandering	v@rAnd@rIng
verantwoorden	v@rAntwo:rd@n
verbeeld	v@rbe:ld
verbeeldeenig	v@rbe:ldIng
verbeeterhuis	v@rbe:t@rh9ys
verbeuren	v@rb2:r@n
verbeurte	v@rb2:rt@
verbiedende	v@rbid@nd@
verblommen	v@rblOmm@n
verbod		v@rbOd
verboôn		v@rbo:n
verbrot		v@rbrOt
verbruid	v@rbr9yd
verdedigen	v@rde:d@g@n
verder		v@rd@r
verdicht	v@rdIcht
verdichte	v@rdIcht@
verdrenken	v@rdrEnk@n
verdriet	v@rdrit
verdwynen	v@rdwEin@n
vereerde	v@re:rd@
vereering	v@re:rIng
vereischt	v@rEist
vergaaderd	v@rga:d@rd
vergaderd	v@rga:d@rd
vergeeten	v@rge:t@n
vergult		v@rgYlt
vergund		v@rgYnd
verhaal		v@rha:l
verhoedinge	v@rhudIng@
verhoên		v@rhun
verhoole	v@rho:l@
verhoolen	v@rho:l@n
verhoopende	v@rho:p@nd@
verhoor		v@rho:r
verifieeren	ve:rifie:r@n
verkeerd	v@rke:rd
verkeert	v@rke:rt
verkiesen	v@rkis@n
verklaard	v@rkla:rd
verklaaren	v@rkla:r@n
verklaaring	v@rkla:rIng
verklaring	v@rkla:rIng
verkogte	v@rkOgte
verkoopen	v@rko:p@n
verkopen	v@rko:p@n
verkort		v@rkOrt
verlaat		v@rla:t
verlaaten	v@rla:t@n
verlaatende	v@rla:t@nd@
verlaeten	v@rla:t@nd@
verlang		v@rlAng
verleegen	v@rle:g@n
verleenen	v@rle:n@n
verleent	v@rle:nt
verleeren	v@rle:r@n
verlichten	v@rlIcht@n
verliefde	v@rlifd
verliesen	v@rlis@n
verliezen	v@rlis@n
verlijen	v@rlEi@n
verloope	v@rlo:p@
verlooren	v@rlo:r@n
vermaak		v@rma:k
vermaek		v@rma:k
vermeeren	v@rme:r@n
vermits		v@rmIts
vermogen	v@rmo:g@n
vermooren	v@rmo:r@n
verplicht	v@rplIcht
verrast		v@rrAst
verre		vErr@
verschiet	v@rschit
verschil	v@rschIl
versjerde	v@rsird@
versmelt	v@rsmElt
versoek		v@rsuk
versoekende	v@rsuk@nd@
versoope	v@rso:p@
verspreijen	v@rsprEi@n
verstaaje	v@rsta:j@
verstaan	v@rsta:n
verstaat	v@rsta:t
verstaeje	v@rsta:j@
verstaen	v@rsta:n
verstaet	v@rsta:t
verstand	v@rstAnd
verstande	v@rstAnd@
verstommen	v@rstOmm@n
verstooren	v@rsto:r@n
verstreeken	v@rstre:k@n
versuffen	v@rsYff@n
vertoond	v@rto:nd
vertoonen	v@rto:n@rs
vertooners	v@rto:n@rs
vertoont	v@rto:nt
vertrekken	v@rtrEkk@n
vertrokken	v@rtrOkk@n
vertrouw	v@rtrAuw
vertrouwen	v@rtrAuw@n
verveelt	v@rve:lt
verwarring	v@rwArrIng
verwyt		v@rwEit
verwyten	v@rwEit@n
verzachten	v@rzAcht@n
verzeekerd	v@rze:k@erd
verzetten	v@rzEtt@n
verzoek		v@rzukt
verzorgt	v@rzOrgt
vette		vEtt@
veul		v2:l
veur		v2:r
vier		vir
vierde		vird@
vierschaar	virscha:r
villen		vIll@n
vind		vInd
vinden		vInd@n
violenta	vio:lEnta:
vischryk	vIschrEik
vissen		vIss@n
vleijen		vlEi@n
vleu		vl2:
vliegen		vlig@n
vliegend	vlig@nd
vliegt		vligt
vloer		vlur
vloo		vlo:
vloog		vlo:g
vlucht		vlYcht
vlugge		vlYgg@
voddemoêr	vOdd@nmur
voddery		vOdd@rEi
voegt		vugt
voel		vul
voelende	vul@nd@
voelt		vult
voeren		vur@n
voet		vut
voeten		vut@n
voetjes		vutj@s
voetteeren	vutte:r@n
voên		vun
vol		vOl
voldongen	vOldOng@n
volg		vOlg
volgen		vOlg@n
volgende	vOlg@nd@
volgt		vOlgt
volk		vOlk
volkje		vOlkj@
volkomentlyk	vOlko:m@ntl@k
voltrekken	vOltrEkk@n
voltrokken	vOltrOkk@n
vond		vOnd
vonden		vOnd@n
vonnis		vOnnIs
voogd		vo:gd
voor		vo:r
voorbaet	vo:rba:t
voordeel	vo:rde:l
vooren		vo:r@n
voorgemelde	vo:rg@mEld@
voorheen	vo:rhe:n
voorheenen	vo:rhe:n@n
voorige		vo:r@g@
voorkoomen	vo:rko:m@n
voornaamentlyk	vo:rna:m@ntl@k
voornaamst	vo:rna:mst
voorsz		vo:rsz
voort		vo:rt
voortgaan	vo:rtga:n
voortgebracht	vo:rtg@brAcht
voorts		vo:rts
voorvallen	vo:rvAll@n
voorwaar	vo:rwa:r
voorzeeker	vo:rze:k@r
vorder		vOrd@r
vorsten		vOrst@n
vóor		vo:r
vraagen		vra:g@n
vrachtman	vrAchtmAn
vraegen		vra:g@n
vredelyk	vre:d@l@k
vreden		vre:d@n
vreeden		vre:d@n
vreemde		vre:md@
vreemdigheid	vre:md@ghEid
vrees		vre:s
vreezen		vre:z@n
vreijen		vrEi@n
vreijer		vrEi@r
vreijers	vrEi@rs
vreugd		vr2:gd
vreugde		vr2:gd@
vriend		vrind
vrienden	vrind@n
vriendschap	vrindschAp
vrijelyk	vrEi@l@k
vrijen		vrEi@n
vrijerlyken	vrEi@rl@k@n
vrijers		vrEi@rs
vrind		vrInd
vrinden		vrInd@n
vrindschap	vrIndschAp
vroedwyf	vrudwEif
vroeg		vrug
vroegjes	vrugj@s
vroeten		vrut@n
vroom		vro:m
vroome		vro:m@
vrucht		vrYcht
vruchtbaer	vrYchtba:r
vry		vrEi
vryft		vrEift
vryheid		vrEihEit
vryster		vrEist@r
vrysters	vrEist@rs
vryven		vrEiv@n
vuil		v9yl
vuilbaard	v9ylba:rd
vuile		v9yl@
vuist		v9yst
vyf		vEif
vyfde		vEifd@
vyftien		vEiftin
vygen		vEig@n
vyven		vEiv@n

waafels		wa:f@ls
waagen		wa:g@n
waar		wa:r
waard		wa:rd
waardig		wa:rd@g
waaren		wa:r@n
waarheid	wa:rhEid
waarlyke	wa:rl@k@
waarom		wa:rOm
waasem		wa:s@m
wacht		wAcht
wachten		wAcht@n
wachtje		wAchtj@
waer		wa:r
waerdig		wa:rd@g
waereld		wa:r@ld
waergenomen	wa:rg@no:m@n
waerom		wa:rOm
waerschouw	wa:rschAuw
waert		wa:rt
waeyen		wa:i@n
wakker		wAkk@r
wal		wAl
wambus		wAmb9ys
wandeling	wAnd@lIng
wangen		wAng@n
wanneer		wAnne:r
want		wAnt
waren		wa:r@n
warm		wArm
warme		wArm@
was		wAs
wassenaar	wAss@na:r
wat		wAt
water		wa:t@r
waters		wa:t@rs
watte		wAtte
weder		we:d@r
wederga		we:d@rga:
wederhouden	we:d@rhAud@n
wederleggen	we:d@rlEgg@n
wederlegging	we:d@rlEggIng
wedervraagen	we:d@rvra:g@n
wederzyde	we:d@rzEid@
wederzyds	we:d@rzEids
weeken		we:k@n
weer		we:r
weerom		we:rOm
weerparthy	we:rpArtEi
wees		we:s
weesen		we:s@n
weesende	we:s@nd@
weeshuis	we:sh9ys
weeshuys	we:sh9ys
weet		we:t
weeten		we:t@n
weetens		we:t@ns
weetenschap	we:t@nschAp
weezen		we:z@n
weêr		we:r
weêrom		we:rOm
weêrzyds	we:rzEids
weg		wEg
wel		wEl
weleboore	we:l@bo:r@
welk		wElk
welke		wElk@
welriekende	wElrik@nd@
wer		wEr
wercken		wErck@n
werd		wErd
werden		wErd@n
werdende	wErd@nd@
werk		wErk
werken		wErk@n
werkje		wErkj@
wesen		we:s@n
westvriesland	wEstvrislAnd
wet		wEt
weten		we:t@n
wetenschap	we:t@nschAp
wetten		wEtt@n
wickevoort	wIck@vo:rt
wie		wi
wieg		wig
wiel		wil
wiens		wins
wier		wir
wierd		wird
wil		wIl
wilje		wIlj@
willen		wIll@n
willende	wIll@nd@
wilspeelen	wIlspe:l@n
wilt		wIlt	
winnen		wInn@n
wint		wInt
winter		wInt@r
wis		wIs
woekeraar	wuk@ra:r
wollenaajen	wOll@na:j@n
wond		wOnd
wonder		wOnd@r
woonen		wo:n@n
woord		wo:rd
woorden		wo:rd@n
word		wOrd
worden		wOrd@n
wordend		wOrd@nd
wordende	wOrd@nd@
wordje		wOrdj@
worreld		wOrr@ld
wou		wAu
wreed		wre:d
wroedwyf	wrudwEif
wrong		wrOng
wurm		wUrm
wy		wEi
wyd		wEid
wyders		wEid@rs
wyf		wEif
wyl		wEil
wylje		wEilj@
wyn		wEin
wys		wEis
wyse		wEis@
wyst		wEist
wyvenrok	wEiv@nrOk
wyze		wEiz@
wyzen		wEiz@n
wyzer		wEiz@r
		
yder		id@er	
ygelyk		Eig@l@k
ymand		imAnd
ymands		imAnds
ypecryt		ip@crit
ys		Eis
yverig		Eiv@r@g

zaak		za:k
zaaken		za:k@n
zaakje		za:kj@
zaam		za:m
zaamen		za:m@n
zaamenspraaken	za:m@nspra:k@n
zachjes		zAchj@s
zacht		zAcht
zachter		zAcht@r
zachtzinnig	zAchtzInn@g
zaek		za:k
zaekje		za:kj@
zaem		za:m
zaemen		za:m@n
zagje		zAgj@
zak		zAk
zakken		zAkk@n
zakpyp		zAkpEip
zal		zAl
zaligmakers	za:l@gma:k@rs
zalje		zAlj@
zalmen		zAlmEn
zalze		zAlz@
zand		zAnd
zat		zAt
ze		z@
zee		ze:
zeeker		ze:k@r
zeeper		ze:p@r
zeg		zEg
zegele		ze:g@l@
zeggen		zEgg@n
zeggens		zEgg@ns
zegje		zEgj@
zegt		zEgt
zei		zEi
zeid		zEid
zeit		zEit
zel		zEl
zelf		zElf	
zelfs		zElfs
zelje		zElj@
zelve		zElv@
zelven		zElv@n
zelver		zElv@r
zend		zEnd
zes		zEs
zet		zEt
zetten		zEtt@n
zettende	zEtt@nd@
zeun		z2:n
zeunen		z2:n@n
zeven		ze:v@n
zevende		ze:v@nd@
zich		zIch	
zie		zi
zien		zin
ziet		zit
zieter		zit@e
zin		zIn
zingen		zIng@n
zingt		zIngt
zinnen		zInn@n
zinnespeelingen		zInn@spe:lIng@n
zit		zIt
zitplaatzen	zItpla:ts@n
zitten		zItt@n
zittens		zItt@ns
zo		zo:
zocht		zOcht
zodaanige	zo:da:n@g@
zoek		zuk
zoen		zun
zoenen		zun@n
zoet		zut
zoete		zut@
zoetjes		zutj@s
zomtyds		zOmtEids
zonder		zOnd@r
zonderling	zOnd@rlIng
zonlicht	zOnlIcht
zonneschynen	zOnn@schEin
zoon		zo:n
zorg		zOrg
zou		zAu
zoud		zAud
zouden		zAud@n
zouw		zAuw
zucht		zYcht
zuchtende	zYcht@nd@
zuigen		z9yg@n
zuikerbroodshoed	z9yk@rbro:dshud	
zuipen		z9yp@n
zulk		zYlk
zulks		zYlks
zulleks		zYll@ks
zullen		zYll@n
zult		zYlt
zusje		zYsj@
zwaare		zwa:r@
zwaarigheid	zwa:r@ghEid
zwaer		zwa:r
zwak		zwAk
zwarigheid	zwa:r@ghEid
zwart		zwArt
zweer		zwe:r
zweeren		zwe:r@n
zweet		zwe:t
zwelgen		zwElg@n
zwichten	zwIcht@n
zwier		zwir
zwiertje	zwirtj@
zwoer		zwur
zwygen		zwEig@n
zwygende	zwEig@nd@
zy		zEi
zyde		zEid@
zyn		zEin
zynd		zEind
zynde		zEind@
zyne		zEin@
zynen		zEin@n
zyt		zEit
